from_totally_fake_account,Z-score_count,IQR_count,Isolation_Forest_count,Total_anomalies,risk_level
1000,12,88,116,216,medium-low-risk
10000,18,100,130,248,medium-high-risk
100000,24,141,172,337,high-risk
100002,37,157,188,382,high-risk
100019,11,142,165,318,medium-high-risk
100021,0,0,0,0,low-risk
100023,0,0,0,0,low-risk
100027,0,0,0,0,low-risk
10004,28,104,122,254,medium-high-risk
100053,12,120,143,275,medium-high-risk
100056,0,0,0,0,low-risk
100060,38,157,191,386,high-risk
100064,0,0,0,0,low-risk
100065,0,0,0,0,low-risk
100083,0,0,0,0,low-risk
100086,12,125,206,343,high-risk
100094,12,130,165,307,medium-high-risk
100098,12,125,146,283,medium-high-risk
100105,12,170,135,317,medium-high-risk
100115,31,178,256,465,high-risk
100120,12,134,240,386,high-risk
100126,15,151,244,410,high-risk
10013,0,0,0,0,low-risk
100137,12,113,78,203,medium-low-risk
100138,0,0,0,0,low-risk
100140,0,0,0,0,low-risk
100142,0,0,0,0,low-risk
100144,12,135,230,377,high-risk
100153,0,0,0,0,low-risk
100155,30,138,179,347,high-risk
100159,29,195,300,524,high-risk
100163,0,0,0,0,low-risk
100165,0,0,0,0,low-risk
100166,12,104,125,241,medium-low-risk
100169,17,82,146,245,medium-high-risk
100171,12,187,222,421,high-risk
100175,0,0,0,0,low-risk
100186,0,0,0,0,low-risk
100197,22,132,178,332,high-risk
100198,33,176,253,462,high-risk
1002,15,100,148,263,medium-high-risk
10021,29,116,276,421,high-risk
100214,13,132,210,355,high-risk
100217,0,0,0,0,low-risk
100219,0,0,0,0,low-risk
100223,12,156,161,329,medium-high-risk
100224,30,101,163,294,medium-high-risk
100228,0,0,0,0,low-risk
100233,22,119,154,295,medium-high-risk
100250,12,176,205,393,high-risk
100261,0,0,0,0,low-risk
100264,12,100,116,228,medium-low-risk
100273,12,122,147,281,medium-high-risk
100274,0,0,0,0,low-risk
100275,0,0,0,0,low-risk
100280,0,0,0,0,low-risk
100282,49,152,226,427,high-risk
100295,0,0,0,0,low-risk
100297,0,0,0,0,low-risk
10030,0,0,0,0,low-risk
100300,16,67,107,190,medium-low-risk
100301,12,128,165,305,medium-high-risk
100302,0,0,0,0,low-risk
100305,0,0,0,0,low-risk
100324,14,96,153,263,medium-high-risk
100338,12,169,221,402,high-risk
100348,14,140,224,378,high-risk
100368,0,0,0,0,low-risk
100373,0,0,0,0,low-risk
100376,12,151,226,389,high-risk
100384,12,82,95,189,medium-low-risk
100385,17,146,186,349,high-risk
100401,0,0,0,0,low-risk
100420,12,86,126,224,medium-low-risk
100423,17,127,166,310,medium-high-risk
100445,15,78,121,214,medium-low-risk
100446,0,0,0,0,low-risk
100455,0,0,0,0,low-risk
100466,12,310,322,644,high-risk
100472,12,122,204,338,high-risk
100478,25,135,279,439,high-risk
100480,0,0,0,0,low-risk
100483,12,119,109,240,medium-low-risk
100488,0,0,0,0,low-risk
100489,12,127,170,309,medium-high-risk
100493,32,179,254,465,high-risk
100517,0,0,0,0,low-risk
100537,31,143,174,348,high-risk
100541,18,131,179,328,medium-high-risk
100546,0,0,0,0,low-risk
100568,0,0,0,0,low-risk
100569,12,144,160,316,medium-high-risk
100570,0,0,0,0,low-risk
100572,0,0,0,0,low-risk
100573,11,130,136,277,medium-high-risk
100583,27,164,259,450,high-risk
100593,12,162,148,322,medium-high-risk
100595,0,0,0,0,low-risk
100599,0,0,0,0,low-risk
1006,25,171,259,455,high-risk
100600,0,0,0,0,low-risk
100608,12,155,189,356,high-risk
100611,0,0,0,0,low-risk
100613,12,154,193,359,high-risk
100614,30,145,183,358,high-risk
100617,0,0,0,0,low-risk
100618,12,90,132,234,medium-low-risk
10062,15,74,119,208,medium-low-risk
100620,0,0,0,0,low-risk
100621,20,91,122,233,medium-low-risk
100622,0,0,0,0,low-risk
100625,0,0,0,0,low-risk
100635,0,0,0,0,low-risk
100636,12,127,181,320,medium-high-risk
100640,13,164,222,399,high-risk
100645,12,100,142,254,medium-high-risk
100656,12,141,166,319,medium-high-risk
100658,20,125,172,317,medium-high-risk
100662,0,0,0,0,low-risk
100664,0,0,0,0,low-risk
100687,12,104,124,240,medium-low-risk
100688,12,127,170,309,medium-high-risk
100690,24,155,204,383,high-risk
100694,27,156,213,396,high-risk
100703,20,109,222,351,high-risk
100708,0,0,0,0,low-risk
100709,0,0,0,0,low-risk
100727,0,0,0,0,low-risk
100728,0,0,0,0,low-risk
100735,0,0,0,0,low-risk
100736,12,118,158,288,medium-high-risk
100746,0,0,0,0,low-risk
100751,13,138,217,368,high-risk
100752,0,0,0,0,low-risk
100754,0,0,0,0,low-risk
100758,0,0,0,0,low-risk
100766,12,116,146,274,medium-high-risk
100774,0,0,0,0,low-risk
10078,11,82,108,201,medium-low-risk
100782,19,114,152,285,medium-high-risk
100786,0,0,0,0,low-risk
100788,0,0,0,0,low-risk
100796,12,113,154,279,medium-high-risk
100800,12,124,170,306,medium-high-risk
100803,0,0,0,0,low-risk
100805,17,99,150,266,medium-high-risk
100817,0,0,0,0,low-risk
100818,13,141,201,355,high-risk
100820,12,167,186,365,high-risk
100827,26,137,166,329,medium-high-risk
100832,0,0,0,0,low-risk
100848,42,123,206,371,high-risk
100856,0,0,0,0,low-risk
100859,14,109,135,258,medium-high-risk
100861,0,0,0,0,low-risk
100866,18,150,197,365,high-risk
100873,12,141,191,344,high-risk
100875,0,0,0,0,low-risk
100892,0,0,0,0,low-risk
100897,0,0,0,0,low-risk
100901,19,72,151,242,medium-low-risk
100906,23,82,132,237,medium-low-risk
100909,12,87,116,215,medium-low-risk
10091,0,0,0,0,low-risk
10092,12,148,161,321,medium-high-risk
100925,12,82,115,209,medium-low-risk
100927,33,113,151,297,medium-high-risk
100931,19,171,275,465,high-risk
100934,28,123,162,313,medium-high-risk
100947,47,136,197,380,high-risk
10096,0,0,0,0,low-risk
100967,0,0,0,0,low-risk
100984,0,0,0,0,low-risk
100986,34,115,202,351,high-risk
100988,29,129,167,325,medium-high-risk
10099,12,93,138,243,medium-low-risk
10116,0,0,0,0,low-risk
10126,12,100,130,242,medium-low-risk
10130,12,139,74,225,medium-low-risk
10134,39,173,224,436,high-risk
10140,0,0,0,0,low-risk
10141,12,225,158,395,high-risk
10142,0,0,0,0,low-risk
10145,17,100,309,426,high-risk
10147,12,113,126,251,medium-high-risk
10152,0,0,0,0,low-risk
10156,13,124,161,298,medium-high-risk
10165,0,0,0,0,low-risk
10167,0,0,0,0,low-risk
10169,0,0,0,0,low-risk
10172,0,0,0,0,low-risk
10179,21,153,183,357,high-risk
1018,22,74,167,263,medium-high-risk
10180,12,119,167,298,medium-high-risk
10192,0,0,0,0,low-risk
10197,0,0,0,0,low-risk
10209,12,118,154,284,medium-high-risk
10211,0,0,0,0,low-risk
10215,12,100,128,240,medium-low-risk
1023,0,0,0,0,low-risk
10240,0,0,0,0,low-risk
10253,12,151,384,547,high-risk
10254,12,111,194,317,medium-high-risk
10259,35,148,163,346,high-risk
10266,0,0,0,0,low-risk
10267,0,0,0,0,low-risk
10280,31,99,126,256,medium-high-risk
10296,0,0,0,0,low-risk
10300,15,138,188,341,high-risk
10302,0,0,0,0,low-risk
10314,26,139,188,353,high-risk
10320,18,121,166,305,medium-high-risk
10356,13,156,326,495,high-risk
10371,12,124,168,304,medium-high-risk
10384,0,0,0,0,low-risk
10386,25,94,131,250,medium-high-risk
10389,0,0,0,0,low-risk
10394,0,0,0,0,low-risk
10395,0,0,0,0,low-risk
10400,0,0,0,0,low-risk
10402,32,145,279,456,high-risk
10410,12,99,181,292,medium-high-risk
10420,0,0,0,0,low-risk
10427,0,0,0,0,low-risk
10432,16,161,208,385,high-risk
10436,0,0,0,0,low-risk
10442,13,101,137,251,medium-high-risk
10451,12,109,183,304,medium-high-risk
10454,12,107,170,289,medium-high-risk
10464,14,90,118,222,medium-low-risk
10466,0,0,0,0,low-risk
10479,16,145,186,347,high-risk
10480,0,0,0,0,low-risk
10485,15,172,368,555,high-risk
10489,0,0,0,0,low-risk
10500,0,0,0,0,low-risk
10501,0,0,0,0,low-risk
10505,0,0,0,0,low-risk
10514,26,140,193,359,high-risk
10515,0,0,0,0,low-risk
10520,14,126,233,373,high-risk
10521,12,96,120,228,medium-low-risk
10525,0,0,0,0,low-risk
10526,0,0,0,0,low-risk
1053,23,121,166,310,medium-high-risk
10534,0,0,0,0,low-risk
10538,26,148,173,347,high-risk
10548,0,0,0,0,low-risk
1055,0,0,0,0,low-risk
10571,0,0,0,0,low-risk
10572,12,109,150,271,medium-high-risk
10581,12,237,202,451,high-risk
10586,12,98,142,252,medium-high-risk
1059,12,124,181,317,medium-high-risk
10592,27,117,165,309,medium-high-risk
10596,0,0,0,0,low-risk
10605,12,88,107,207,medium-low-risk
10606,12,129,172,313,medium-high-risk
10607,0,0,0,0,low-risk
1062,0,0,0,0,low-risk
10634,17,115,166,298,medium-high-risk
10636,28,110,173,311,medium-high-risk
10637,0,0,0,0,low-risk
10638,0,0,0,0,low-risk
1064,0,0,0,0,low-risk
10641,12,104,136,252,medium-high-risk
10659,11,136,119,266,medium-high-risk
10673,0,0,0,0,low-risk
10693,13,105,140,258,medium-high-risk
10694,0,0,0,0,low-risk
10695,12,140,162,314,medium-high-risk
10696,17,159,201,377,high-risk
10703,0,0,0,0,low-risk
10709,40,97,189,326,medium-high-risk
1071,18,94,129,241,medium-low-risk
10716,37,118,157,312,medium-high-risk
10724,0,0,0,0,low-risk
10727,0,0,0,0,low-risk
10730,0,0,0,0,low-risk
10740,12,103,134,249,medium-high-risk
10743,12,113,113,238,medium-low-risk
10744,0,0,0,0,low-risk
10747,0,0,0,0,low-risk
10748,0,0,0,0,low-risk
10764,0,0,0,0,low-risk
10765,12,138,134,284,medium-high-risk
1078,31,118,185,334,high-risk
1079,0,0,0,0,low-risk
10792,0,0,0,0,low-risk
10794,12,116,150,278,medium-high-risk
10806,0,0,0,0,low-risk
10813,32,141,180,353,high-risk
10819,22,119,148,289,medium-high-risk
10821,0,0,0,0,low-risk
10826,20,151,216,387,high-risk
10834,0,0,0,0,low-risk
10840,0,0,0,0,low-risk
10855,12,113,159,284,medium-high-risk
1086,21,143,206,370,high-risk
10864,0,0,0,0,low-risk
10866,35,146,178,359,high-risk
1087,18,75,125,218,medium-low-risk
10871,0,0,0,0,low-risk
10881,0,0,0,0,low-risk
10887,0,0,0,0,low-risk
10913,12,152,199,363,high-risk
10916,0,0,0,0,low-risk
10928,0,0,0,0,low-risk
1093,0,0,0,0,low-risk
10937,12,145,217,374,high-risk
10942,0,0,0,0,low-risk
10944,12,112,166,290,medium-high-risk
10963,12,96,150,258,medium-high-risk
10974,0,0,0,0,low-risk
10983,12,113,159,284,medium-high-risk
1099,0,0,0,0,low-risk
11000,0,0,0,0,low-risk
11005,0,0,0,0,low-risk
11008,12,95,124,231,medium-low-risk
11012,12,164,227,403,high-risk
11020,0,0,0,0,low-risk
11039,24,99,148,271,medium-high-risk
11054,17,81,129,227,medium-low-risk
11056,15,81,130,226,medium-low-risk
11057,10,147,255,412,high-risk
11066,0,0,0,0,low-risk
11092,0,0,0,0,low-risk
11096,22,100,143,265,medium-high-risk
11099,20,96,148,264,medium-high-risk
11100,12,116,139,267,medium-high-risk
11105,12,144,229,385,high-risk
11111,12,131,255,398,high-risk
11120,30,161,221,412,high-risk
11124,16,167,241,424,high-risk
1113,26,103,150,279,medium-high-risk
11131,0,0,0,0,low-risk
11133,12,102,123,237,medium-low-risk
11135,0,0,0,0,low-risk
11137,12,91,125,228,medium-low-risk
11143,24,122,172,318,medium-high-risk
11145,13,108,152,273,medium-high-risk
11151,0,0,0,0,low-risk
11156,0,0,0,0,low-risk
11163,14,115,133,262,medium-high-risk
11167,31,147,183,361,high-risk
11171,20,80,117,217,medium-low-risk
11177,12,181,247,440,high-risk
11182,24,141,186,351,high-risk
11183,12,129,164,305,medium-high-risk
11197,24,85,150,259,medium-high-risk
1120,12,105,197,314,medium-high-risk
11201,0,0,0,0,low-risk
11202,27,280,262,569,high-risk
11211,20,114,170,304,medium-high-risk
11213,26,131,206,363,high-risk
1122,12,110,117,239,medium-low-risk
11229,0,0,0,0,low-risk
11230,0,0,0,0,low-risk
11232,13,153,335,501,high-risk
11237,14,70,115,199,medium-low-risk
11239,12,181,272,465,high-risk
11244,0,0,0,0,low-risk
11248,0,0,0,0,low-risk
1125,16,94,127,237,medium-low-risk
11252,12,181,203,396,high-risk
11256,12,103,146,261,medium-high-risk
11261,0,0,0,0,low-risk
11267,0,0,0,0,low-risk
11303,46,146,204,396,high-risk
11307,0,0,0,0,low-risk
11310,0,0,0,0,low-risk
11314,11,142,158,311,medium-high-risk
11322,0,0,0,0,low-risk
11324,0,0,0,0,low-risk
11329,0,0,0,0,low-risk
1133,12,132,159,303,medium-high-risk
11343,15,109,144,268,medium-high-risk
11347,44,140,229,413,high-risk
11350,0,0,0,0,low-risk
11370,17,109,162,288,medium-high-risk
11379,12,149,198,359,high-risk
11382,25,123,214,362,high-risk
11383,0,0,0,0,low-risk
11387,0,0,0,0,low-risk
11396,0,0,0,0,low-risk
11401,20,141,168,329,medium-high-risk
11405,12,126,163,301,medium-high-risk
11406,0,0,0,0,low-risk
11416,0,0,0,0,low-risk
11417,12,110,188,310,medium-high-risk
1142,18,89,148,255,medium-high-risk
11420,39,119,188,346,high-risk
11421,31,106,173,310,medium-high-risk
11426,12,173,192,377,high-risk
11431,0,0,0,0,low-risk
11444,0,0,0,0,low-risk
11448,43,150,220,413,high-risk
11451,11,128,160,299,medium-high-risk
11454,13,120,142,275,medium-high-risk
11456,0,0,0,0,low-risk
11458,0,0,0,0,low-risk
11460,48,148,208,404,high-risk
11464,0,0,0,0,low-risk
11465,0,0,0,0,low-risk
11466,13,140,226,379,high-risk
11472,0,0,0,0,low-risk
11475,12,162,176,350,high-risk
1149,0,0,0,0,low-risk
11494,16,165,250,431,high-risk
11505,12,107,127,246,medium-high-risk
11545,0,0,0,0,low-risk
11550,46,77,321,444,high-risk
11554,0,0,0,0,low-risk
11559,12,126,176,314,medium-high-risk
11560,0,0,0,0,low-risk
11561,0,0,0,0,low-risk
11563,16,154,258,428,high-risk
11568,14,115,209,338,high-risk
11570,15,129,182,326,medium-high-risk
11577,16,93,137,246,medium-high-risk
11582,0,0,0,0,low-risk
11584,0,0,0,0,low-risk
1159,0,0,0,0,low-risk
11613,12,216,140,368,high-risk
11619,13,152,176,341,high-risk
11620,12,147,185,344,high-risk
11628,12,188,219,419,high-risk
11630,12,120,152,284,medium-high-risk
11636,21,90,132,243,medium-low-risk
1164,0,0,0,0,low-risk
11648,12,98,122,232,medium-low-risk
11655,0,0,0,0,low-risk
11662,12,152,194,358,high-risk
11672,0,0,0,0,low-risk
11673,12,104,69,185,medium-low-risk
11680,16,73,115,204,medium-low-risk
11683,12,92,133,237,medium-low-risk
1169,0,0,0,0,low-risk
11694,12,128,147,287,medium-high-risk
11714,0,0,0,0,low-risk
11722,0,0,0,0,low-risk
11729,12,150,196,358,high-risk
11730,0,0,0,0,low-risk
11734,12,117,147,276,medium-high-risk
11736,0,0,0,0,low-risk
1174,18,76,127,221,medium-low-risk
11742,11,96,97,204,medium-low-risk
11750,0,0,0,0,low-risk
11752,0,0,0,0,low-risk
11755,33,148,200,381,high-risk
11756,12,115,139,266,medium-high-risk
11757,0,0,0,0,low-risk
11762,26,224,181,431,high-risk
11765,15,127,186,328,medium-high-risk
11774,0,0,0,0,low-risk
11778,0,0,0,0,low-risk
11779,0,0,0,0,low-risk
11786,15,124,222,361,high-risk
1179,12,127,150,289,medium-high-risk
1180,12,152,115,279,medium-high-risk
11813,13,74,105,192,medium-low-risk
11821,17,160,203,380,high-risk
11822,12,73,79,164,medium-low-risk
11823,12,119,221,352,high-risk
11827,12,90,111,213,medium-low-risk
11834,0,0,0,0,low-risk
1184,0,0,0,0,low-risk
1186,39,145,206,390,high-risk
11872,12,111,123,246,medium-high-risk
11889,0,0,0,0,low-risk
1189,34,132,203,369,high-risk
11907,14,153,205,372,high-risk
11913,0,0,0,0,low-risk
11921,12,117,199,328,medium-high-risk
11926,12,125,159,296,medium-high-risk
11941,0,0,0,0,low-risk
11944,0,0,0,0,low-risk
11949,0,0,0,0,low-risk
11961,12,85,105,202,medium-low-risk
11964,19,140,195,354,high-risk
11965,12,113,125,250,medium-high-risk
11971,21,144,194,359,high-risk
11976,12,192,241,445,high-risk
11977,0,0,0,0,low-risk
11979,0,0,0,0,low-risk
11988,15,68,149,232,medium-low-risk
12001,12,78,112,202,medium-low-risk
12002,0,0,0,0,low-risk
12006,15,92,139,246,medium-high-risk
12013,0,0,0,0,low-risk
12015,0,0,0,0,low-risk
12020,0,0,0,0,low-risk
12026,14,74,125,213,medium-low-risk
12035,12,118,158,288,medium-high-risk
12037,0,0,0,0,low-risk
12048,12,138,149,299,medium-high-risk
12052,0,0,0,0,low-risk
12060,23,162,219,404,high-risk
12061,0,0,0,0,low-risk
12069,12,140,186,338,high-risk
12070,0,0,0,0,low-risk
12076,0,0,0,0,low-risk
12077,0,0,0,0,low-risk
12082,0,0,0,0,low-risk
12092,0,0,0,0,low-risk
12095,19,116,173,308,medium-high-risk
1210,12,72,101,185,medium-low-risk
12101,31,168,204,403,high-risk
12114,0,0,0,0,low-risk
12122,16,66,105,187,medium-low-risk
12125,0,0,0,0,low-risk
12127,12,107,212,331,high-risk
12139,0,0,0,0,low-risk
1214,12,160,187,359,high-risk
12141,0,0,0,0,low-risk
12144,25,132,170,327,medium-high-risk
12148,27,137,239,403,high-risk
12154,12,131,184,327,medium-high-risk
12160,0,0,0,0,low-risk
12162,0,0,0,0,low-risk
12164,12,120,164,296,medium-high-risk
12165,0,0,0,0,low-risk
1217,23,126,186,335,high-risk
12177,0,0,0,0,low-risk
12179,12,119,138,269,medium-high-risk
1218,0,0,0,0,low-risk
12182,20,108,190,318,medium-high-risk
12183,0,0,0,0,low-risk
12184,37,113,158,308,medium-high-risk
12185,0,0,0,0,low-risk
12190,12,145,157,314,medium-high-risk
12197,12,154,179,345,high-risk
12202,12,104,102,218,medium-low-risk
12229,28,127,172,327,medium-high-risk
12259,16,79,150,245,medium-high-risk
12270,0,0,0,0,low-risk
12271,0,0,0,0,low-risk
12285,0,0,0,0,low-risk
12290,24,155,191,370,high-risk
12301,0,0,0,0,low-risk
12302,0,0,0,0,low-risk
12316,20,138,242,400,high-risk
12329,12,146,204,362,high-risk
1233,0,0,0,0,low-risk
12332,0,0,0,0,low-risk
1234,12,146,193,351,high-risk
12351,12,121,125,258,medium-high-risk
12356,16,155,185,356,high-risk
12357,0,0,0,0,low-risk
12359,23,157,199,379,high-risk
12361,0,0,0,0,low-risk
12368,0,0,0,0,low-risk
12378,13,166,304,483,high-risk
1238,0,0,0,0,low-risk
12382,0,0,0,0,low-risk
12384,21,241,205,467,high-risk
12387,20,113,141,274,medium-high-risk
12391,14,115,147,276,medium-high-risk
12396,12,105,147,264,medium-high-risk
12403,12,101,144,257,medium-high-risk
12407,18,86,190,294,medium-high-risk
12420,0,0,0,0,low-risk
12424,12,160,201,373,high-risk
1243,0,0,0,0,low-risk
12430,0,0,0,0,low-risk
12435,37,139,190,366,high-risk
12443,12,95,116,223,medium-low-risk
12453,0,0,0,0,low-risk
12461,0,0,0,0,low-risk
12463,0,0,0,0,low-risk
12464,0,0,0,0,low-risk
12470,12,103,142,257,medium-high-risk
12478,23,134,185,342,high-risk
1248,0,0,0,0,low-risk
12501,12,141,168,321,medium-high-risk
12510,0,0,0,0,low-risk
12520,12,87,152,251,medium-high-risk
12525,12,157,193,362,high-risk
12542,38,130,254,422,high-risk
12543,0,0,0,0,low-risk
1255,11,110,201,322,medium-high-risk
12555,0,0,0,0,low-risk
1256,0,0,0,0,low-risk
12563,13,119,173,305,medium-high-risk
12568,12,103,136,251,medium-high-risk
1258,24,129,176,329,medium-high-risk
12585,12,120,158,290,medium-high-risk
12611,0,0,0,0,low-risk
12630,12,104,156,272,medium-high-risk
12635,0,0,0,0,low-risk
12637,0,0,0,0,low-risk
12649,32,146,195,373,high-risk
1265,0,0,0,0,low-risk
12650,12,85,104,201,medium-low-risk
12652,12,131,215,358,high-risk
12658,34,133,172,339,high-risk
12665,12,147,169,328,medium-high-risk
12669,0,0,0,0,low-risk
12673,35,133,152,320,medium-high-risk
12679,0,0,0,0,low-risk
12688,0,0,0,0,low-risk
1269,0,0,0,0,low-risk
12692,0,0,0,0,low-risk
12695,12,156,140,308,medium-high-risk
12699,12,94,124,230,medium-low-risk
12706,0,0,0,0,low-risk
12709,12,158,202,372,high-risk
12714,0,0,0,0,low-risk
12715,0,0,0,0,low-risk
12716,0,0,0,0,low-risk
12728,12,172,180,364,high-risk
12733,50,240,339,629,high-risk
12738,12,114,161,287,medium-high-risk
12740,0,0,0,0,low-risk
12750,0,0,0,0,low-risk
12753,0,0,0,0,low-risk
12774,12,190,239,441,high-risk
12781,23,144,239,406,high-risk
12782,12,146,197,355,high-risk
12799,0,0,0,0,low-risk
12800,23,112,177,312,medium-high-risk
12805,0,0,0,0,low-risk
12812,0,0,0,0,low-risk
12818,11,105,131,247,medium-high-risk
12826,0,0,0,0,low-risk
12831,12,167,179,358,high-risk
12834,0,0,0,0,low-risk
12838,0,0,0,0,low-risk
12840,0,0,0,0,low-risk
12846,0,0,0,0,low-risk
12847,0,0,0,0,low-risk
1285,0,0,0,0,low-risk
12853,0,0,0,0,low-risk
12857,0,0,0,0,low-risk
12870,0,0,0,0,low-risk
12872,0,0,0,0,low-risk
12873,0,0,0,0,low-risk
12885,0,0,0,0,low-risk
12886,0,0,0,0,low-risk
12899,0,0,0,0,low-risk
12900,0,0,0,0,low-risk
12903,12,117,156,285,medium-high-risk
12913,55,155,258,468,high-risk
12929,12,116,230,358,high-risk
12935,12,121,153,286,medium-high-risk
12944,0,0,0,0,low-risk
12947,0,0,0,0,low-risk
12950,0,0,0,0,low-risk
12953,0,0,0,0,low-risk
12964,12,100,125,237,medium-low-risk
12971,42,159,186,387,high-risk
12977,0,0,0,0,low-risk
12984,0,0,0,0,low-risk
12985,0,0,0,0,low-risk
12988,26,163,233,422,high-risk
1299,18,170,211,399,high-risk
12993,12,114,173,299,medium-high-risk
12995,0,0,0,0,low-risk
13001,21,110,289,420,high-risk
13003,0,0,0,0,low-risk
13009,0,0,0,0,low-risk
13016,0,0,0,0,low-risk
13019,13,66,94,173,medium-low-risk
13022,0,0,0,0,low-risk
13023,13,79,131,223,medium-low-risk
1304,12,98,129,239,medium-low-risk
13044,0,0,0,0,low-risk
13047,28,136,183,347,high-risk
13054,36,198,284,518,high-risk
13055,12,99,236,347,high-risk
13069,34,210,322,566,high-risk
13072,12,157,252,421,high-risk
1309,12,132,152,296,medium-high-risk
13100,15,166,205,386,high-risk
13101,0,0,0,0,low-risk
13105,0,0,0,0,low-risk
13109,0,0,0,0,low-risk
1311,0,0,0,0,low-risk
13126,0,0,0,0,low-risk
13132,0,0,0,0,low-risk
13133,12,87,128,227,medium-low-risk
13137,0,0,0,0,low-risk
13148,23,200,166,389,high-risk
13152,14,107,231,352,high-risk
13160,0,0,0,0,low-risk
13165,12,146,178,336,high-risk
13174,21,125,167,313,medium-high-risk
13198,0,0,0,0,low-risk
13205,12,139,184,335,high-risk
13219,12,266,294,572,high-risk
13225,17,83,146,246,medium-high-risk
13226,12,112,190,314,medium-high-risk
1323,15,140,208,363,high-risk
1324,0,0,0,0,low-risk
13243,39,132,186,357,high-risk
13246,12,142,164,318,medium-high-risk
13252,13,135,176,324,medium-high-risk
13270,14,126,184,324,medium-high-risk
13273,28,131,168,327,medium-high-risk
13278,12,151,172,335,high-risk
13285,0,0,0,0,low-risk
13296,0,0,0,0,low-risk
13299,19,119,165,303,medium-high-risk
13301,0,0,0,0,low-risk
13309,0,0,0,0,low-risk
13311,22,253,173,448,high-risk
13319,0,0,0,0,low-risk
1332,0,0,0,0,low-risk
13326,0,0,0,0,low-risk
13344,12,156,202,370,high-risk
13357,0,0,0,0,low-risk
13372,22,105,179,306,medium-high-risk
13375,29,157,246,432,high-risk
13383,0,0,0,0,low-risk
13384,12,158,202,372,high-risk
13389,0,0,0,0,low-risk
13392,12,143,168,323,medium-high-risk
13393,0,0,0,0,low-risk
13395,0,0,0,0,low-risk
1340,0,0,0,0,low-risk
13417,0,0,0,0,low-risk
13421,0,0,0,0,low-risk
13429,12,124,178,314,medium-high-risk
13432,0,0,0,0,low-risk
13434,0,0,0,0,low-risk
13453,29,136,233,398,high-risk
13458,0,0,0,0,low-risk
13467,0,0,0,0,low-risk
13485,12,87,111,210,medium-low-risk
13488,0,0,0,0,low-risk
13495,0,0,0,0,low-risk
13502,12,139,252,403,high-risk
13508,24,136,199,359,high-risk
13531,0,0,0,0,low-risk
13532,0,0,0,0,low-risk
13536,12,93,106,211,medium-low-risk
13557,0,0,0,0,low-risk
1356,0,0,0,0,low-risk
1357,16,110,163,289,medium-high-risk
13571,0,0,0,0,low-risk
13601,0,0,0,0,low-risk
13609,0,0,0,0,low-risk
13610,0,0,0,0,low-risk
13611,12,154,167,333,high-risk
13613,12,155,195,362,high-risk
13615,0,0,0,0,low-risk
13616,0,0,0,0,low-risk
13624,0,0,0,0,low-risk
13626,0,0,0,0,low-risk
13633,21,112,147,280,medium-high-risk
13642,0,0,0,0,low-risk
13677,12,115,141,268,medium-high-risk
13681,0,0,0,0,low-risk
1369,0,0,0,0,low-risk
13690,16,125,187,328,medium-high-risk
13723,0,0,0,0,low-risk
13724,12,132,156,300,medium-high-risk
13736,0,0,0,0,low-risk
13738,12,99,170,281,medium-high-risk
13757,0,0,0,0,low-risk
13773,0,0,0,0,low-risk
13778,16,126,139,281,medium-high-risk
13798,13,153,208,374,high-risk
13807,0,0,0,0,low-risk
13808,12,126,145,283,medium-high-risk
1382,12,118,212,342,high-risk
13822,13,83,142,238,medium-low-risk
13824,30,106,166,302,medium-high-risk
13851,0,0,0,0,low-risk
13853,0,0,0,0,low-risk
13865,31,133,197,361,high-risk
13871,0,0,0,0,low-risk
13875,0,0,0,0,low-risk
13881,12,135,234,381,high-risk
13883,0,0,0,0,low-risk
13886,15,95,133,243,medium-low-risk
1390,0,0,0,0,low-risk
13903,20,149,198,367,high-risk
13904,37,118,209,364,high-risk
13927,15,81,130,226,medium-low-risk
1393,41,137,173,351,high-risk
13935,0,0,0,0,low-risk
13942,0,0,0,0,low-risk
13944,20,114,156,290,medium-high-risk
13946,0,0,0,0,low-risk
13977,14,163,198,375,high-risk
1399,12,144,156,312,medium-high-risk
13991,12,118,138,268,medium-high-risk
13993,24,104,146,274,medium-high-risk
13998,0,0,0,0,low-risk
14001,0,0,0,0,low-risk
14005,0,0,0,0,low-risk
14019,0,0,0,0,low-risk
14027,0,0,0,0,low-risk
14032,37,123,207,367,high-risk
14036,12,174,187,373,high-risk
14040,15,126,158,299,medium-high-risk
14056,0,0,0,0,low-risk
14069,12,188,127,327,medium-high-risk
14071,0,0,0,0,low-risk
14073,12,149,178,339,high-risk
14074,15,78,98,191,medium-low-risk
14083,0,0,0,0,low-risk
14084,20,146,213,379,high-risk
14087,0,0,0,0,low-risk
14097,16,89,165,270,medium-high-risk
1410,0,0,0,0,low-risk
14101,23,139,225,387,high-risk
14121,0,0,0,0,low-risk
14124,12,109,136,257,medium-high-risk
14135,12,138,233,383,high-risk
14139,12,122,175,309,medium-high-risk
14146,0,0,0,0,low-risk
14147,55,132,182,369,high-risk
14152,0,0,0,0,low-risk
14154,27,127,190,344,high-risk
14160,12,143,240,395,high-risk
14161,0,0,0,0,low-risk
14167,12,105,147,264,medium-high-risk
14177,0,0,0,0,low-risk
14179,20,101,153,274,medium-high-risk
14183,0,0,0,0,low-risk
14187,0,0,0,0,low-risk
14190,17,114,211,342,high-risk
14202,13,132,171,316,medium-high-risk
14214,12,165,245,422,high-risk
14216,0,0,0,0,low-risk
14218,0,0,0,0,low-risk
14236,0,0,0,0,low-risk
14243,12,134,178,324,medium-high-risk
14247,0,0,0,0,low-risk
14254,0,0,0,0,low-risk
14263,0,0,0,0,low-risk
14270,12,153,192,357,high-risk
14272,19,133,271,423,high-risk
14277,12,152,206,370,high-risk
14289,12,226,179,417,high-risk
14326,12,176,190,378,high-risk
1433,12,96,144,252,medium-high-risk
14345,12,95,124,231,medium-low-risk
14358,12,162,219,393,high-risk
14360,24,151,228,403,high-risk
14362,26,118,149,293,medium-high-risk
14372,27,144,192,363,high-risk
14388,12,88,119,219,medium-low-risk
14392,0,0,0,0,low-risk
14410,0,0,0,0,low-risk
14415,0,0,0,0,low-risk
14420,43,156,192,391,high-risk
14424,12,166,235,413,high-risk
14426,17,116,179,312,medium-high-risk
1443,27,137,165,329,medium-high-risk
1444,0,0,0,0,low-risk
14446,12,123,233,368,high-risk
14448,12,140,176,328,medium-high-risk
14452,12,130,171,313,medium-high-risk
14458,28,151,216,395,high-risk
14460,45,139,394,578,high-risk
14467,52,122,272,446,high-risk
14468,12,74,88,174,medium-low-risk
14493,0,0,0,0,low-risk
14496,15,125,156,296,medium-high-risk
14500,13,86,125,224,medium-low-risk
14502,0,0,0,0,low-risk
14506,13,116,155,284,medium-high-risk
14519,0,0,0,0,low-risk
14520,12,123,155,290,medium-high-risk
14527,12,113,191,316,medium-high-risk
1453,0,0,0,0,low-risk
14534,13,117,220,350,high-risk
14543,11,126,223,360,high-risk
14544,0,0,0,0,low-risk
14547,31,142,214,387,high-risk
14556,12,223,178,413,high-risk
14559,0,0,0,0,low-risk
14563,38,140,184,362,high-risk
14577,28,149,309,486,high-risk
1458,0,0,0,0,low-risk
14582,28,111,146,285,medium-high-risk
1459,0,0,0,0,low-risk
14590,12,123,152,287,medium-high-risk
14593,15,108,147,270,medium-high-risk
14598,12,112,138,262,medium-high-risk
1460,21,188,176,385,high-risk
14601,21,120,224,365,high-risk
14611,20,98,159,277,medium-high-risk
14634,23,109,152,284,medium-high-risk
14639,0,0,0,0,low-risk
14650,0,0,0,0,low-risk
14662,25,135,199,359,high-risk
14673,0,0,0,0,low-risk
14685,30,101,140,271,medium-high-risk
14692,13,111,208,332,high-risk
14697,12,101,130,243,medium-low-risk
1471,12,150,153,315,medium-high-risk
14715,0,0,0,0,low-risk
1472,0,0,0,0,low-risk
14724,34,119,174,327,medium-high-risk
14730,0,0,0,0,low-risk
14749,12,110,154,276,medium-high-risk
14754,12,150,180,342,high-risk
1476,0,0,0,0,low-risk
14769,22,145,226,393,high-risk
14779,0,0,0,0,low-risk
14785,0,0,0,0,low-risk
14788,18,87,123,228,medium-low-risk
14793,12,85,137,234,medium-low-risk
14815,0,0,0,0,low-risk
1482,0,0,0,0,low-risk
14837,31,115,184,330,high-risk
14840,0,0,0,0,low-risk
14845,12,113,151,276,medium-high-risk
14846,0,0,0,0,low-risk
14847,0,0,0,0,low-risk
14850,12,113,119,244,medium-low-risk
14865,19,152,208,379,high-risk
14867,32,154,221,407,high-risk
1487,30,113,188,331,high-risk
14876,0,0,0,0,low-risk
14877,11,278,415,704,high-risk
14878,0,0,0,0,low-risk
14879,12,129,145,286,medium-high-risk
1489,12,86,100,198,medium-low-risk
14894,12,134,154,300,medium-high-risk
14899,22,118,271,411,high-risk
1490,12,146,243,401,high-risk
14900,0,0,0,0,low-risk
14913,12,152,202,366,high-risk
14918,12,138,126,276,medium-high-risk
14929,12,128,155,295,medium-high-risk
14930,12,138,186,336,high-risk
14935,29,143,151,323,medium-high-risk
14955,12,134,201,347,high-risk
14970,0,0,0,0,low-risk
14980,0,0,0,0,low-risk
14987,0,0,0,0,low-risk
14995,12,150,173,335,high-risk
15004,0,0,0,0,low-risk
15018,0,0,0,0,low-risk
15032,0,0,0,0,low-risk
1505,31,113,164,308,medium-high-risk
15063,12,104,116,232,medium-low-risk
1507,31,173,215,419,high-risk
15078,41,113,167,321,medium-high-risk
15083,29,158,187,374,high-risk
15086,21,104,174,299,medium-high-risk
15088,0,0,0,0,low-risk
15104,0,0,0,0,low-risk
15129,0,0,0,0,low-risk
15132,12,102,117,231,medium-low-risk
15135,12,122,149,283,medium-high-risk
15145,0,0,0,0,low-risk
15148,46,165,208,419,high-risk
15152,0,0,0,0,low-risk
15165,29,143,171,343,high-risk
15169,12,134,117,263,medium-high-risk
15171,14,116,216,346,high-risk
15173,24,117,210,351,high-risk
15176,0,0,0,0,low-risk
1518,0,0,0,0,low-risk
15181,0,0,0,0,low-risk
15184,13,128,175,316,medium-high-risk
15197,12,112,132,256,medium-high-risk
1520,0,0,0,0,low-risk
15200,0,0,0,0,low-risk
15205,0,0,0,0,low-risk
15210,0,0,0,0,low-risk
15214,12,105,142,259,medium-high-risk
15219,21,101,143,265,medium-high-risk
15239,30,130,174,334,high-risk
15240,14,141,229,384,high-risk
15250,12,146,218,376,high-risk
15258,12,109,115,236,medium-low-risk
15264,12,75,100,187,medium-low-risk
15265,12,167,208,387,high-risk
15266,0,0,0,0,low-risk
15272,0,0,0,0,low-risk
15274,41,171,291,503,high-risk
15277,12,80,153,245,medium-high-risk
15284,0,0,0,0,low-risk
15289,0,0,0,0,low-risk
1529,13,118,143,274,medium-high-risk
15294,0,0,0,0,low-risk
15301,0,0,0,0,low-risk
15305,0,0,0,0,low-risk
15315,17,105,171,293,medium-high-risk
15317,0,0,0,0,low-risk
15320,37,149,175,361,high-risk
15321,0,0,0,0,low-risk
15324,0,0,0,0,low-risk
15343,17,105,123,245,medium-high-risk
15347,12,149,241,402,high-risk
15350,12,127,173,312,medium-high-risk
15353,12,174,209,395,high-risk
15354,12,159,283,454,high-risk
15370,0,0,0,0,low-risk
15377,13,99,162,274,medium-high-risk
1538,0,0,0,0,low-risk
15381,24,133,238,395,high-risk
15382,12,73,107,192,medium-low-risk
15386,0,0,0,0,low-risk
15387,12,162,181,355,high-risk
15393,14,101,139,254,medium-high-risk
15396,0,0,0,0,low-risk
15400,12,102,141,255,medium-high-risk
15408,0,0,0,0,low-risk
15414,0,0,0,0,low-risk
15418,12,146,208,366,high-risk
15424,32,117,164,313,medium-high-risk
15429,0,0,0,0,low-risk
15431,21,99,154,274,medium-high-risk
15438,27,153,219,399,high-risk
15444,18,130,171,319,medium-high-risk
15454,12,118,171,301,medium-high-risk
15460,12,105,133,250,medium-high-risk
15468,24,177,239,440,high-risk
15471,54,164,327,545,high-risk
15480,0,0,0,0,low-risk
15483,12,148,82,242,medium-low-risk
15497,0,0,0,0,low-risk
15500,0,0,0,0,low-risk
15501,21,88,153,262,medium-high-risk
15514,0,0,0,0,low-risk
15515,11,95,136,242,medium-low-risk
15521,0,0,0,0,low-risk
15533,0,0,0,0,low-risk
15538,13,101,119,233,medium-low-risk
15550,12,134,169,315,medium-high-risk
1556,0,0,0,0,low-risk
15575,12,115,78,205,medium-low-risk
15585,12,155,183,350,high-risk
15597,13,124,241,378,high-risk
15612,0,0,0,0,low-risk
15613,13,147,211,371,high-risk
15618,12,148,202,362,high-risk
15622,0,0,0,0,low-risk
15624,0,0,0,0,low-risk
15629,12,156,252,420,high-risk
1563,17,114,219,350,high-risk
15633,23,138,190,351,high-risk
15640,0,0,0,0,low-risk
15663,12,150,214,376,high-risk
1569,14,121,164,299,medium-high-risk
1570,0,0,0,0,low-risk
15711,12,176,206,394,high-risk
15714,0,0,0,0,low-risk
15717,12,142,147,301,medium-high-risk
1572,42,149,195,386,high-risk
15730,14,132,182,328,medium-high-risk
15737,12,148,184,344,high-risk
15738,17,88,116,221,medium-low-risk
15767,0,0,0,0,low-risk
15788,12,124,153,289,medium-high-risk
15789,0,0,0,0,low-risk
15823,12,177,177,366,high-risk
15829,24,98,169,291,medium-high-risk
15831,0,0,0,0,low-risk
15838,12,133,160,305,medium-high-risk
15839,0,0,0,0,low-risk
15867,12,131,180,323,medium-high-risk
15880,13,137,184,334,high-risk
15888,0,0,0,0,low-risk
15892,0,0,0,0,low-risk
15896,28,183,232,443,high-risk
15897,0,0,0,0,low-risk
15898,0,0,0,0,low-risk
15900,0,0,0,0,low-risk
15901,0,0,0,0,low-risk
15908,0,0,0,0,low-risk
15911,35,191,263,489,high-risk
15912,0,0,0,0,low-risk
15922,0,0,0,0,low-risk
15929,15,137,170,322,medium-high-risk
15932,0,0,0,0,low-risk
15935,12,163,188,363,high-risk
15938,12,149,165,326,medium-high-risk
15940,0,0,0,0,low-risk
15944,45,134,145,324,medium-high-risk
15952,12,105,171,288,medium-high-risk
15954,12,93,143,248,medium-high-risk
15959,0,0,0,0,low-risk
1596,13,88,121,222,medium-low-risk
15960,0,0,0,0,low-risk
15961,0,0,0,0,low-risk
15964,12,102,109,223,medium-low-risk
15969,0,0,0,0,low-risk
15973,0,0,0,0,low-risk
15975,23,167,198,388,high-risk
15976,0,0,0,0,low-risk
15979,0,0,0,0,low-risk
1598,0,0,0,0,low-risk
15994,0,0,0,0,low-risk
15998,0,0,0,0,low-risk
16004,12,139,160,311,medium-high-risk
16005,0,0,0,0,low-risk
16006,12,160,194,366,high-risk
16007,12,134,145,291,medium-high-risk
16014,0,0,0,0,low-risk
16015,12,148,167,327,medium-high-risk
16016,31,160,207,398,high-risk
16019,17,146,218,381,high-risk
16020,14,107,200,321,medium-high-risk
16029,12,93,141,246,medium-high-risk
16034,19,161,219,399,high-risk
16045,0,0,0,0,low-risk
16056,12,120,182,314,medium-high-risk
16066,20,140,175,335,high-risk
1607,12,132,176,320,medium-high-risk
16070,25,117,157,299,medium-high-risk
1609,0,0,0,0,low-risk
16105,23,144,229,396,high-risk
16108,0,0,0,0,low-risk
16128,12,149,195,356,high-risk
16133,12,128,206,346,high-risk
16141,12,163,239,414,high-risk
1615,12,155,196,363,high-risk
16155,43,191,229,463,high-risk
1618,0,0,0,0,low-risk
16183,15,118,221,354,high-risk
16187,29,141,171,341,high-risk
16192,32,138,188,358,high-risk
16209,0,0,0,0,low-risk
1621,0,0,0,0,low-risk
16210,14,317,297,628,high-risk
16211,0,0,0,0,low-risk
16213,25,124,205,354,high-risk
16216,12,154,161,327,medium-high-risk
16218,0,0,0,0,low-risk
1622,12,106,159,277,medium-high-risk
1623,12,160,184,356,high-risk
16234,0,0,0,0,low-risk
16246,12,91,128,231,medium-low-risk
16247,20,129,152,301,medium-high-risk
16249,34,256,242,532,high-risk
16257,24,155,220,399,high-risk
16264,0,0,0,0,low-risk
16265,0,0,0,0,low-risk
16272,12,98,127,237,medium-low-risk
16274,25,152,183,360,high-risk
16275,12,144,179,335,high-risk
16287,23,141,172,336,high-risk
16291,12,164,306,482,high-risk
16299,44,134,208,386,high-risk
1630,0,0,0,0,low-risk
16302,0,0,0,0,low-risk
16306,16,156,151,323,medium-high-risk
16308,12,97,126,235,medium-low-risk
1631,15,153,275,443,high-risk
16318,12,151,181,344,high-risk
16329,0,0,0,0,low-risk
16334,12,134,184,330,high-risk
16338,12,87,121,220,medium-low-risk
16339,24,156,204,384,high-risk
1634,12,125,137,274,medium-high-risk
16341,0,0,0,0,low-risk
16348,0,0,0,0,low-risk
16354,0,0,0,0,low-risk
16357,20,90,166,276,medium-high-risk
16365,17,103,159,279,medium-high-risk
16366,0,0,0,0,low-risk
16367,12,131,176,319,medium-high-risk
1639,14,121,167,302,medium-high-risk
16392,33,169,262,464,high-risk
16401,12,159,208,379,high-risk
16406,12,135,183,330,high-risk
16414,12,160,195,367,high-risk
16419,27,98,272,397,high-risk
1642,12,102,121,235,medium-low-risk
16425,12,104,201,317,medium-high-risk
16429,12,128,165,305,medium-high-risk
1644,15,90,123,228,medium-low-risk
16444,12,104,128,244,medium-low-risk
16453,0,0,0,0,low-risk
16464,13,113,196,322,medium-high-risk
16468,12,96,149,257,medium-high-risk
16469,29,173,235,437,high-risk
16475,24,118,165,307,medium-high-risk
16482,0,0,0,0,low-risk
16490,0,0,0,0,low-risk
16491,0,0,0,0,low-risk
16499,0,0,0,0,low-risk
16503,22,122,205,349,high-risk
16506,12,163,197,372,high-risk
16509,12,155,188,355,high-risk
16510,0,0,0,0,low-risk
16523,12,123,177,312,medium-high-risk
16524,0,0,0,0,low-risk
16532,18,141,219,378,high-risk
16539,12,122,138,272,medium-high-risk
1654,0,0,0,0,low-risk
16544,14,120,178,312,medium-high-risk
16546,12,127,166,305,medium-high-risk
16570,0,0,0,0,low-risk
16584,0,0,0,0,low-risk
16588,31,117,131,279,medium-high-risk
16594,0,0,0,0,low-risk
16595,0,0,0,0,low-risk
16601,21,129,219,369,high-risk
1661,12,159,210,381,high-risk
16610,0,0,0,0,low-risk
16614,0,0,0,0,low-risk
16615,16,100,144,260,medium-high-risk
16616,22,107,175,304,medium-high-risk
16625,0,0,0,0,low-risk
16634,12,116,137,265,medium-high-risk
16638,29,100,136,265,medium-high-risk
16647,13,83,127,223,medium-low-risk
16649,18,74,129,221,medium-low-risk
16652,21,122,227,370,high-risk
16658,0,0,0,0,low-risk
16670,0,0,0,0,low-risk
16689,16,127,153,296,medium-high-risk
16698,12,127,157,296,medium-high-risk
1670,0,0,0,0,low-risk
16701,0,0,0,0,low-risk
16704,0,0,0,0,low-risk
16706,12,137,177,326,medium-high-risk
16709,19,223,138,380,high-risk
16710,0,0,0,0,low-risk
16715,14,113,157,284,medium-high-risk
16724,0,0,0,0,low-risk
16726,0,0,0,0,low-risk
1673,0,0,0,0,low-risk
16731,26,108,135,269,medium-high-risk
16739,12,96,137,245,medium-high-risk
16742,0,0,0,0,low-risk
16744,0,0,0,0,low-risk
1675,12,139,152,303,medium-high-risk
16751,23,119,150,292,medium-high-risk
16753,38,156,205,399,high-risk
16779,28,146,192,366,high-risk
16783,0,0,0,0,low-risk
16784,12,153,173,338,high-risk
16798,0,0,0,0,low-risk
16801,14,135,239,388,high-risk
16802,14,120,176,310,medium-high-risk
16803,0,0,0,0,low-risk
16804,0,0,0,0,low-risk
16817,15,120,144,279,medium-high-risk
16826,14,124,155,293,medium-high-risk
16830,0,0,0,0,low-risk
16832,0,0,0,0,low-risk
16834,18,157,249,424,high-risk
16836,0,0,0,0,low-risk
16843,0,0,0,0,low-risk
16859,0,0,0,0,low-risk
16870,17,136,173,326,medium-high-risk
16875,0,0,0,0,low-risk
16882,12,83,122,217,medium-low-risk
1689,12,125,148,285,medium-high-risk
16902,16,104,168,288,medium-high-risk
16907,12,118,159,289,medium-high-risk
16913,12,126,167,305,medium-high-risk
16914,0,0,0,0,low-risk
16917,0,0,0,0,low-risk
16918,15,171,268,454,high-risk
16928,0,0,0,0,low-risk
16941,12,126,165,303,medium-high-risk
16944,12,136,162,310,medium-high-risk
16948,0,0,0,0,low-risk
16952,12,118,172,302,medium-high-risk
16954,0,0,0,0,low-risk
16958,0,0,0,0,low-risk
16963,0,0,0,0,low-risk
1697,22,110,154,286,medium-high-risk
16972,0,0,0,0,low-risk
16977,0,0,0,0,low-risk
1698,0,0,0,0,low-risk
16986,28,114,150,292,medium-high-risk
16993,24,120,268,412,high-risk
16997,34,160,226,420,high-risk
17004,33,164,342,539,high-risk
17014,0,0,0,0,low-risk
17016,35,144,290,469,high-risk
17021,0,0,0,0,low-risk
17022,0,0,0,0,low-risk
17024,0,0,0,0,low-risk
17025,24,103,144,271,medium-high-risk
17027,58,144,224,426,high-risk
1703,42,177,278,497,high-risk
17034,41,135,198,374,high-risk
17039,0,0,0,0,low-risk
17041,39,105,163,307,medium-high-risk
17048,0,0,0,0,low-risk
17052,27,91,176,294,medium-high-risk
17056,12,102,116,230,medium-low-risk
17057,12,125,151,288,medium-high-risk
17058,0,0,0,0,low-risk
17081,0,0,0,0,low-risk
17087,0,0,0,0,low-risk
17089,12,226,187,425,high-risk
17097,0,0,0,0,low-risk
17098,18,120,158,296,medium-high-risk
17101,0,0,0,0,low-risk
17108,0,0,0,0,low-risk
17117,0,0,0,0,low-risk
17127,12,121,136,269,medium-high-risk
17128,0,0,0,0,low-risk
17130,16,87,128,231,medium-low-risk
17137,13,145,190,348,high-risk
17140,0,0,0,0,low-risk
17143,24,123,182,329,medium-high-risk
1715,12,122,221,355,high-risk
17151,12,199,164,375,high-risk
17152,0,0,0,0,low-risk
17155,29,151,183,363,high-risk
17158,22,179,195,396,high-risk
17161,21,87,163,271,medium-high-risk
17163,43,150,224,417,high-risk
17169,12,156,190,358,high-risk
1717,12,121,139,272,medium-high-risk
1718,12,111,126,249,medium-high-risk
17181,18,138,182,338,high-risk
17185,34,105,160,299,medium-high-risk
17191,47,183,208,438,high-risk
17195,12,143,174,329,medium-high-risk
17196,15,110,206,331,high-risk
17210,12,124,157,293,medium-high-risk
17213,18,133,189,340,high-risk
17224,0,0,0,0,low-risk
17225,12,101,147,260,medium-high-risk
17228,0,0,0,0,low-risk
17231,23,119,151,293,medium-high-risk
17243,13,78,97,188,medium-low-risk
1725,0,0,0,0,low-risk
17256,12,126,186,324,medium-high-risk
17259,12,104,131,247,medium-high-risk
17267,25,90,144,259,medium-high-risk
17276,22,152,236,410,high-risk
17287,12,122,142,276,medium-high-risk
17291,12,140,149,301,medium-high-risk
17294,12,90,111,213,medium-low-risk
1730,13,150,230,393,high-risk
17300,0,0,0,0,low-risk
17307,0,0,0,0,low-risk
1731,0,0,0,0,low-risk
17310,0,0,0,0,low-risk
17311,12,119,198,329,medium-high-risk
17316,0,0,0,0,low-risk
17323,12,116,112,240,medium-low-risk
17328,17,147,258,422,high-risk
17353,0,0,0,0,low-risk
1736,15,120,196,331,high-risk
17360,13,124,195,332,high-risk
17377,0,0,0,0,low-risk
17379,12,193,229,434,high-risk
17382,19,85,118,222,medium-low-risk
17383,18,88,147,253,medium-high-risk
17397,16,117,151,284,medium-high-risk
17398,12,194,227,433,high-risk
17401,0,0,0,0,low-risk
17411,0,0,0,0,low-risk
17413,13,77,115,205,medium-low-risk
17419,12,129,142,283,medium-high-risk
17424,12,135,173,320,medium-high-risk
17427,12,99,134,245,medium-high-risk
17434,15,144,224,383,high-risk
17443,11,109,129,249,medium-high-risk
17467,12,127,155,294,medium-high-risk
17469,12,150,186,348,high-risk
17479,12,86,109,207,medium-low-risk
17480,0,0,0,0,low-risk
17484,0,0,0,0,low-risk
17487,14,142,240,396,high-risk
17517,12,104,133,249,medium-high-risk
17526,13,149,212,374,high-risk
17527,0,0,0,0,low-risk
17528,12,147,215,374,high-risk
17539,12,111,147,270,medium-high-risk
1754,0,0,0,0,low-risk
17545,0,0,0,0,low-risk
17547,0,0,0,0,low-risk
17548,0,0,0,0,low-risk
17552,0,0,0,0,low-risk
17555,11,88,108,207,medium-low-risk
17569,12,92,108,212,medium-low-risk
1757,20,148,197,365,high-risk
17573,0,0,0,0,low-risk
17575,0,0,0,0,low-risk
17580,0,0,0,0,low-risk
17582,0,0,0,0,low-risk
17602,0,0,0,0,low-risk
17608,12,143,271,426,high-risk
17613,12,103,129,244,medium-low-risk
17622,34,110,132,276,medium-high-risk
17624,50,161,209,420,high-risk
17625,0,0,0,0,low-risk
17643,0,0,0,0,low-risk
17646,0,0,0,0,low-risk
17647,12,132,168,312,medium-high-risk
17662,12,232,162,406,high-risk
17664,0,0,0,0,low-risk
17665,0,0,0,0,low-risk
17669,0,0,0,0,low-risk
17670,12,119,175,306,medium-high-risk
17673,0,0,0,0,low-risk
17679,25,121,218,364,high-risk
17682,31,113,155,299,medium-high-risk
17691,0,0,0,0,low-risk
1770,0,0,0,0,low-risk
17707,55,186,219,460,high-risk
1771,0,0,0,0,low-risk
17717,29,116,142,287,medium-high-risk
17723,0,0,0,0,low-risk
17726,0,0,0,0,low-risk
17729,0,0,0,0,low-risk
17730,12,185,240,437,high-risk
17735,36,129,175,340,high-risk
17741,12,159,187,358,high-risk
17744,16,110,175,301,medium-high-risk
17750,12,98,151,261,medium-high-risk
17756,12,139,191,342,high-risk
17758,0,0,0,0,low-risk
17761,13,91,198,302,medium-high-risk
17763,26,123,164,313,medium-high-risk
17765,27,116,178,321,medium-high-risk
17769,55,146,208,409,high-risk
1777,0,0,0,0,low-risk
17773,0,0,0,0,low-risk
17781,12,162,178,352,high-risk
17788,0,0,0,0,low-risk
17794,14,113,223,350,high-risk
17800,0,0,0,0,low-risk
17813,12,187,206,405,high-risk
17827,0,0,0,0,low-risk
17830,13,121,153,287,medium-high-risk
17836,0,0,0,0,low-risk
1784,12,137,253,402,high-risk
17843,0,0,0,0,low-risk
17844,35,135,191,361,high-risk
17852,0,0,0,0,low-risk
17857,20,123,145,288,medium-high-risk
1786,12,140,215,367,high-risk
17884,12,128,143,283,medium-high-risk
17897,0,0,0,0,low-risk
17905,36,120,158,314,medium-high-risk
17919,0,0,0,0,low-risk
17920,0,0,0,0,low-risk
17929,0,0,0,0,low-risk
1793,20,136,214,370,high-risk
17938,12,149,236,397,high-risk
17943,0,0,0,0,low-risk
17944,0,0,0,0,low-risk
17946,48,140,185,373,high-risk
17947,19,124,168,311,medium-high-risk
17966,0,0,0,0,low-risk
17975,0,0,0,0,low-risk
17977,20,104,152,276,medium-high-risk
17980,0,0,0,0,low-risk
1799,36,168,262,466,high-risk
1800,12,72,105,189,medium-low-risk
18013,0,0,0,0,low-risk
18015,0,0,0,0,low-risk
18035,25,167,211,403,high-risk
18041,12,107,144,263,medium-high-risk
18057,14,90,155,259,medium-high-risk
18058,0,0,0,0,low-risk
1806,0,0,0,0,low-risk
18061,18,141,180,339,high-risk
18075,11,119,146,276,medium-high-risk
1808,12,127,159,298,medium-high-risk
18104,0,0,0,0,low-risk
18105,31,133,171,335,high-risk
18107,25,150,232,407,high-risk
18114,18,135,182,335,high-risk
18116,12,163,194,369,high-risk
1812,0,0,0,0,low-risk
18120,0,0,0,0,low-risk
18124,0,0,0,0,low-risk
1813,0,0,0,0,low-risk
18134,0,0,0,0,low-risk
18142,12,122,161,295,medium-high-risk
1815,30,132,169,331,high-risk
18153,44,176,212,432,high-risk
18161,28,137,198,363,high-risk
18164,17,148,176,341,high-risk
18168,15,129,126,270,medium-high-risk
18173,0,0,0,0,low-risk
18179,12,83,121,216,medium-low-risk
18195,18,103,162,283,medium-high-risk
18197,0,0,0,0,low-risk
18199,32,114,189,335,high-risk
18208,12,171,194,377,high-risk
18213,0,0,0,0,low-risk
18219,12,176,234,422,high-risk
18228,0,0,0,0,low-risk
1823,12,123,158,293,medium-high-risk
1824,0,0,0,0,low-risk
18252,22,85,156,263,medium-high-risk
18264,0,0,0,0,low-risk
1827,13,150,190,353,high-risk
18275,0,0,0,0,low-risk
1828,16,121,187,324,medium-high-risk
18289,0,0,0,0,low-risk
18311,0,0,0,0,low-risk
18316,0,0,0,0,low-risk
18328,12,154,171,337,high-risk
1833,0,0,0,0,low-risk
18345,0,0,0,0,low-risk
1835,19,88,114,221,medium-low-risk
18351,13,120,205,338,high-risk
18353,12,105,223,340,high-risk
18358,18,78,113,209,medium-low-risk
18364,12,134,134,280,medium-high-risk
18365,12,176,218,406,high-risk
18369,0,0,0,0,low-risk
18371,0,0,0,0,low-risk
1838,12,122,195,329,medium-high-risk
18391,0,0,0,0,low-risk
18399,36,152,245,433,high-risk
18402,12,152,187,351,high-risk
18405,24,197,230,451,high-risk
18410,0,0,0,0,low-risk
18430,20,135,187,342,high-risk
18438,0,0,0,0,low-risk
18454,0,0,0,0,low-risk
1847,0,0,0,0,low-risk
18472,12,111,139,262,medium-high-risk
18473,0,0,0,0,low-risk
18484,0,0,0,0,low-risk
18488,12,153,232,397,high-risk
18495,19,108,158,285,medium-high-risk
18517,0,0,0,0,low-risk
18520,11,144,187,342,high-risk
18528,26,163,221,410,high-risk
18538,21,112,144,277,medium-high-risk
18544,0,0,0,0,low-risk
18545,12,161,187,360,high-risk
18555,35,131,248,414,high-risk
18565,0,0,0,0,low-risk
18580,0,0,0,0,low-risk
18591,0,0,0,0,low-risk
18595,12,159,194,365,high-risk
18602,12,136,172,320,medium-high-risk
18604,34,121,152,307,medium-high-risk
18607,0,0,0,0,low-risk
18611,0,0,0,0,low-risk
18612,0,0,0,0,low-risk
18613,0,0,0,0,low-risk
18630,0,0,0,0,low-risk
18634,15,124,153,292,medium-high-risk
18640,12,134,149,295,medium-high-risk
18648,12,87,124,223,medium-low-risk
18654,30,170,221,421,high-risk
18666,43,123,216,382,high-risk
18669,0,0,0,0,low-risk
18677,0,0,0,0,low-risk
18681,0,0,0,0,low-risk
18682,0,0,0,0,low-risk
18690,12,125,153,290,medium-high-risk
18702,0,0,0,0,low-risk
18715,0,0,0,0,low-risk
18724,0,0,0,0,low-risk
18732,34,94,152,280,medium-high-risk
18742,0,0,0,0,low-risk
18754,15,90,145,250,medium-high-risk
18758,17,129,179,325,medium-high-risk
18761,12,100,145,257,medium-high-risk
18766,0,0,0,0,low-risk
1878,0,0,0,0,low-risk
18786,0,0,0,0,low-risk
18788,13,122,222,357,high-risk
18793,22,87,159,268,medium-high-risk
18800,0,0,0,0,low-risk
18802,12,112,126,250,medium-high-risk
18827,12,180,209,401,high-risk
18834,12,92,110,214,medium-low-risk
18836,16,130,176,322,medium-high-risk
18840,31,119,177,327,medium-high-risk
18852,26,161,199,386,high-risk
18857,0,0,0,0,low-risk
18858,13,101,195,309,medium-high-risk
18860,12,250,169,431,high-risk
18865,24,159,187,370,high-risk
18881,12,132,289,433,high-risk
18882,22,251,218,491,high-risk
18884,0,0,0,0,low-risk
18894,0,0,0,0,low-risk
18898,0,0,0,0,low-risk
18900,0,0,0,0,low-risk
18909,19,100,158,277,medium-high-risk
18919,0,0,0,0,low-risk
18928,12,146,257,415,high-risk
18929,0,0,0,0,low-risk
18944,0,0,0,0,low-risk
18945,12,141,169,322,medium-high-risk
18953,0,0,0,0,low-risk
18976,0,0,0,0,low-risk
18981,12,97,124,233,medium-low-risk
18986,12,227,145,384,high-risk
18987,31,126,181,338,high-risk
18993,12,86,111,209,medium-low-risk
19001,0,0,0,0,low-risk
19005,21,69,131,221,medium-low-risk
19009,0,0,0,0,low-risk
19014,20,134,179,333,high-risk
19015,20,134,185,339,high-risk
19021,0,0,0,0,low-risk
19023,0,0,0,0,low-risk
19027,12,149,224,385,high-risk
19036,28,99,164,291,medium-high-risk
19043,0,0,0,0,low-risk
19053,0,0,0,0,low-risk
19071,12,123,178,313,medium-high-risk
19079,12,120,172,304,medium-high-risk
1908,12,172,209,393,high-risk
19086,0,0,0,0,low-risk
19092,0,0,0,0,low-risk
19093,26,134,169,329,medium-high-risk
19096,0,0,0,0,low-risk
19097,0,0,0,0,low-risk
1910,40,129,174,343,high-risk
19118,0,0,0,0,low-risk
19120,0,0,0,0,low-risk
19124,12,115,136,263,medium-high-risk
19131,12,145,152,309,medium-high-risk
19143,13,100,151,264,medium-high-risk
19146,0,0,0,0,low-risk
19147,21,135,197,353,high-risk
19158,0,0,0,0,low-risk
19160,0,0,0,0,low-risk
19161,0,0,0,0,low-risk
19175,0,0,0,0,low-risk
19176,0,0,0,0,low-risk
19183,12,107,169,288,medium-high-risk
19185,10,126,251,387,high-risk
19195,12,140,195,347,high-risk
19206,12,114,143,269,medium-high-risk
19207,15,106,134,255,medium-high-risk
19208,0,0,0,0,low-risk
19212,13,105,142,260,medium-high-risk
19214,36,119,166,321,medium-high-risk
19221,0,0,0,0,low-risk
19236,20,127,164,311,medium-high-risk
19245,30,202,236,468,high-risk
19255,12,145,157,314,medium-high-risk
19268,34,132,293,459,high-risk
19279,0,0,0,0,low-risk
19302,0,0,0,0,low-risk
19303,0,0,0,0,low-risk
19305,12,160,201,373,high-risk
1931,26,166,198,390,high-risk
19316,12,114,140,266,medium-high-risk
19322,12,146,193,351,high-risk
19325,13,116,205,334,high-risk
19327,12,115,153,280,medium-high-risk
19328,12,109,147,268,medium-high-risk
19335,0,0,0,0,low-risk
19345,0,0,0,0,low-risk
19360,0,0,0,0,low-risk
19369,13,129,219,361,high-risk
19370,23,196,300,519,high-risk
19371,0,0,0,0,low-risk
19388,12,150,175,337,high-risk
19399,36,164,234,434,high-risk
19407,15,143,166,324,medium-high-risk
1941,0,0,0,0,low-risk
19413,13,109,187,309,medium-high-risk
19425,12,126,148,286,medium-high-risk
19426,0,0,0,0,low-risk
19429,12,142,315,469,high-risk
19441,12,161,177,350,high-risk
19446,0,0,0,0,low-risk
19463,0,0,0,0,low-risk
19481,12,142,160,314,medium-high-risk
19486,14,97,206,317,medium-high-risk
19489,12,146,151,309,medium-high-risk
19491,23,83,146,252,medium-high-risk
19519,12,149,241,402,high-risk
19525,0,0,0,0,low-risk
19533,12,155,198,365,high-risk
19544,0,0,0,0,low-risk
19545,44,135,243,422,high-risk
19553,15,88,126,229,medium-low-risk
19561,39,132,188,359,high-risk
19566,33,134,198,365,high-risk
19570,12,113,221,346,high-risk
19572,12,134,172,318,medium-high-risk
19578,0,0,0,0,low-risk
19580,0,0,0,0,low-risk
19589,12,181,195,388,high-risk
19596,13,123,160,296,medium-high-risk
19608,12,176,249,437,high-risk
19613,31,132,208,371,high-risk
19633,14,214,167,395,high-risk
19636,0,0,0,0,low-risk
19641,17,151,223,391,high-risk
19647,0,0,0,0,low-risk
19668,25,106,174,305,medium-high-risk
19672,12,143,162,317,medium-high-risk
19673,0,0,0,0,low-risk
19676,16,245,223,484,high-risk
19680,27,121,231,379,high-risk
19739,0,0,0,0,low-risk
19744,14,84,118,216,medium-low-risk
19757,26,128,210,364,high-risk
19758,12,166,199,377,high-risk
19761,12,149,161,322,medium-high-risk
19767,0,0,0,0,low-risk
19785,12,124,159,295,medium-high-risk
19791,0,0,0,0,low-risk
1980,0,0,0,0,low-risk
19800,0,0,0,0,low-risk
19806,0,0,0,0,low-risk
19810,12,168,216,396,high-risk
19816,16,134,263,413,high-risk
19818,31,137,191,359,high-risk
19820,0,0,0,0,low-risk
19841,21,131,169,321,medium-high-risk
19847,0,0,0,0,low-risk
19878,15,197,320,532,high-risk
19883,0,0,0,0,low-risk
19884,26,126,170,322,medium-high-risk
19885,0,0,0,0,low-risk
1990,12,130,184,326,medium-high-risk
19900,12,97,136,245,medium-high-risk
19903,0,0,0,0,low-risk
19907,23,125,225,373,high-risk
19910,0,0,0,0,low-risk
19927,16,82,124,222,medium-low-risk
19928,12,128,157,297,medium-high-risk
1993,0,0,0,0,low-risk
19932,0,0,0,0,low-risk
19933,0,0,0,0,low-risk
19936,29,127,173,329,medium-high-risk
19944,0,0,0,0,low-risk
19947,18,128,150,296,medium-high-risk
19949,12,151,184,347,high-risk
19950,12,115,161,288,medium-high-risk
19952,12,167,211,390,high-risk
19954,12,146,177,335,high-risk
19959,0,0,0,0,low-risk
19964,12,41,61,114,medium-low-risk
19990,12,126,175,313,medium-high-risk
19993,13,144,185,342,high-risk
20003,12,146,201,359,high-risk
20004,12,131,171,314,medium-high-risk
20005,18,82,225,325,medium-high-risk
20011,38,114,186,338,high-risk
20017,12,190,225,427,high-risk
20025,0,0,0,0,low-risk
20029,22,124,170,316,medium-high-risk
2004,13,116,153,282,medium-high-risk
2005,0,0,0,0,low-risk
20050,12,125,131,268,medium-high-risk
20063,12,131,185,328,medium-high-risk
20076,17,166,257,440,high-risk
20083,0,0,0,0,low-risk
20089,22,110,255,387,high-risk
20099,12,127,226,365,high-risk
20100,48,229,284,561,high-risk
2012,0,0,0,0,low-risk
20130,23,86,131,240,medium-low-risk
20133,56,144,202,402,high-risk
20142,0,0,0,0,low-risk
20145,15,118,158,291,medium-high-risk
20147,16,76,105,197,medium-low-risk
20148,12,152,199,363,high-risk
20153,0,0,0,0,low-risk
20164,12,153,187,352,high-risk
20169,0,0,0,0,low-risk
20179,0,0,0,0,low-risk
2018,0,0,0,0,low-risk
20184,0,0,0,0,low-risk
20186,12,91,139,242,medium-low-risk
20189,0,0,0,0,low-risk
2019,12,114,132,258,medium-high-risk
20191,21,116,168,305,medium-high-risk
20197,12,122,146,280,medium-high-risk
20207,14,125,193,332,high-risk
20210,0,0,0,0,low-risk
20237,0,0,0,0,low-risk
20251,12,192,269,473,high-risk
20252,0,0,0,0,low-risk
20253,29,128,178,335,high-risk
20266,0,0,0,0,low-risk
2029,12,126,189,327,medium-high-risk
2030,12,135,247,394,high-risk
20304,29,119,209,357,high-risk
20317,0,0,0,0,low-risk
20319,0,0,0,0,low-risk
20330,0,0,0,0,low-risk
20339,12,156,173,341,high-risk
20345,0,0,0,0,low-risk
2035,12,114,127,253,medium-high-risk
20365,0,0,0,0,low-risk
20381,12,121,156,289,medium-high-risk
20383,0,0,0,0,low-risk
20388,30,158,207,395,high-risk
20405,0,0,0,0,low-risk
20411,0,0,0,0,low-risk
20424,16,111,150,277,medium-high-risk
20431,23,109,140,272,medium-high-risk
20434,22,107,163,292,medium-high-risk
20435,0,0,0,0,low-risk
2044,15,101,159,275,medium-high-risk
20441,0,0,0,0,low-risk
20449,27,140,186,353,high-risk
2046,0,0,0,0,low-risk
20479,0,0,0,0,low-risk
20486,29,126,192,347,high-risk
20499,0,0,0,0,low-risk
20500,26,137,190,353,high-risk
20502,15,146,198,359,high-risk
20505,44,137,195,376,high-risk
20510,12,138,236,386,high-risk
20514,12,96,130,238,medium-low-risk
20562,0,0,0,0,low-risk
20568,28,141,164,333,high-risk
20572,0,0,0,0,low-risk
20575,31,145,175,351,high-risk
20576,12,113,145,270,medium-high-risk
20577,16,101,151,268,medium-high-risk
20594,44,217,268,529,high-risk
20595,0,0,0,0,low-risk
20597,24,175,237,436,high-risk
20599,0,0,0,0,low-risk
20604,0,0,0,0,low-risk
20610,12,113,134,259,medium-high-risk
2062,0,0,0,0,low-risk
20622,0,0,0,0,low-risk
20639,12,122,155,289,medium-high-risk
20641,0,0,0,0,low-risk
20649,0,0,0,0,low-risk
20652,12,106,131,249,medium-high-risk
20661,12,130,180,322,medium-high-risk
20669,12,86,138,236,medium-low-risk
2069,12,59,114,185,medium-low-risk
2071,12,130,156,298,medium-high-risk
20710,12,130,147,289,medium-high-risk
20717,0,0,0,0,low-risk
2072,0,0,0,0,low-risk
20724,12,93,108,213,medium-low-risk
20725,14,84,151,249,medium-high-risk
20726,12,139,172,323,medium-high-risk
20729,48,129,217,394,high-risk
20746,12,116,152,280,medium-high-risk
20750,0,0,0,0,low-risk
20755,12,134,169,315,medium-high-risk
20756,12,155,214,381,high-risk
20757,12,127,155,294,medium-high-risk
2076,12,179,195,386,high-risk
20764,19,93,120,232,medium-low-risk
20765,0,0,0,0,low-risk
20769,16,142,173,331,high-risk
20770,24,151,212,387,high-risk
20772,40,100,176,316,medium-high-risk
20785,0,0,0,0,low-risk
20786,18,125,168,311,medium-high-risk
20790,13,119,170,302,medium-high-risk
20791,12,157,262,431,high-risk
20792,0,0,0,0,low-risk
20801,55,132,174,361,high-risk
20804,31,166,186,383,high-risk
20815,12,142,162,316,medium-high-risk
20818,12,171,221,404,high-risk
20823,12,141,259,412,high-risk
20827,0,0,0,0,low-risk
20833,12,103,133,248,medium-high-risk
20840,35,129,171,335,high-risk
20841,21,139,191,351,high-risk
20847,12,137,108,257,medium-high-risk
20855,0,0,0,0,low-risk
20863,0,0,0,0,low-risk
20877,0,0,0,0,low-risk
20883,0,0,0,0,low-risk
2090,12,125,172,309,medium-high-risk
2091,0,0,0,0,low-risk
20911,17,126,170,313,medium-high-risk
20912,34,131,172,337,high-risk
20916,19,107,148,274,medium-high-risk
20921,36,151,211,398,high-risk
20923,20,107,145,272,medium-high-risk
20945,0,0,0,0,low-risk
20952,12,137,211,360,high-risk
20955,12,123,135,270,medium-high-risk
20957,12,139,162,313,medium-high-risk
20961,0,0,0,0,low-risk
20962,0,0,0,0,low-risk
20963,0,0,0,0,low-risk
20965,12,128,201,341,high-risk
20966,0,0,0,0,low-risk
2097,34,109,165,308,medium-high-risk
20971,0,0,0,0,low-risk
20972,0,0,0,0,low-risk
20973,0,0,0,0,low-risk
20980,32,125,225,382,high-risk
20981,25,235,288,548,high-risk
20984,29,158,185,372,high-risk
20998,0,0,0,0,low-risk
2100,51,146,258,455,high-risk
21000,27,135,167,329,medium-high-risk
21006,12,183,241,436,high-risk
21007,18,109,150,277,medium-high-risk
21013,0,0,0,0,low-risk
21015,12,120,163,295,medium-high-risk
21016,12,136,176,324,medium-high-risk
21021,12,101,131,244,medium-low-risk
21025,12,96,99,207,medium-low-risk
21061,0,0,0,0,low-risk
21066,37,131,372,540,high-risk
21075,30,171,201,402,high-risk
2108,42,156,199,397,high-risk
21087,12,158,185,355,high-risk
21088,36,149,199,384,high-risk
21092,0,0,0,0,low-risk
21101,12,95,115,222,medium-low-risk
21112,12,128,199,339,high-risk
2112,0,0,0,0,low-risk
21142,0,0,0,0,low-risk
21147,0,0,0,0,low-risk
21152,0,0,0,0,low-risk
21153,28,107,264,399,high-risk
21159,14,130,212,356,high-risk
2116,19,91,185,295,medium-high-risk
21163,0,0,0,0,low-risk
21164,41,199,250,490,high-risk
21174,12,155,166,333,high-risk
21177,12,105,178,295,medium-high-risk
21178,19,131,189,339,high-risk
21185,0,0,0,0,low-risk
2119,0,0,0,0,low-risk
21201,0,0,0,0,low-risk
21206,12,124,197,333,high-risk
21216,0,0,0,0,low-risk
21219,0,0,0,0,low-risk
2122,0,0,0,0,low-risk
21222,33,145,185,363,high-risk
21230,27,125,196,348,high-risk
21237,26,127,167,320,medium-high-risk
21243,0,0,0,0,low-risk
21244,0,0,0,0,low-risk
21248,0,0,0,0,low-risk
21256,0,0,0,0,low-risk
2126,12,102,156,270,medium-high-risk
21274,0,0,0,0,low-risk
21278,12,98,186,296,medium-high-risk
21299,12,96,139,247,medium-high-risk
21307,0,0,0,0,low-risk
21321,63,194,275,532,high-risk
21327,12,101,180,293,medium-high-risk
21343,0,0,0,0,low-risk
21353,51,147,215,413,high-risk
21364,0,0,0,0,low-risk
21367,0,0,0,0,low-risk
21368,16,92,140,248,medium-high-risk
2137,17,86,133,236,medium-low-risk
21370,12,100,130,242,medium-low-risk
21373,0,0,0,0,low-risk
21378,0,0,0,0,low-risk
21382,12,123,194,329,medium-high-risk
21385,13,151,170,334,high-risk
21388,0,0,0,0,low-risk
21389,12,115,151,278,medium-high-risk
21398,0,0,0,0,low-risk
21404,0,0,0,0,low-risk
21412,0,0,0,0,low-risk
2142,0,0,0,0,low-risk
21435,12,103,139,254,medium-high-risk
21444,0,0,0,0,low-risk
21464,0,0,0,0,low-risk
21465,0,0,0,0,low-risk
21476,0,0,0,0,low-risk
21495,0,0,0,0,low-risk
21496,12,159,209,380,high-risk
21507,12,171,248,431,high-risk
21515,35,132,198,365,high-risk
2152,41,119,219,379,high-risk
21526,0,0,0,0,low-risk
21531,0,0,0,0,low-risk
21532,14,203,307,524,high-risk
21555,40,135,171,346,high-risk
21563,13,161,235,409,high-risk
21568,26,113,164,303,medium-high-risk
21573,24,154,197,375,high-risk
21575,12,166,183,361,high-risk
21583,24,96,125,245,medium-high-risk
21586,20,128,172,320,medium-high-risk
21593,29,172,248,449,high-risk
21594,0,0,0,0,low-risk
21596,0,0,0,0,low-risk
21603,18,158,235,411,high-risk
21618,12,72,97,181,medium-low-risk
21631,19,89,159,267,medium-high-risk
21632,0,0,0,0,low-risk
21643,0,0,0,0,low-risk
21647,0,0,0,0,low-risk
21652,0,0,0,0,low-risk
21655,12,147,259,418,high-risk
21657,0,0,0,0,low-risk
21667,36,124,236,396,high-risk
21686,28,203,192,423,high-risk
2171,12,127,161,300,medium-high-risk
21718,12,61,108,181,medium-low-risk
21724,0,0,0,0,low-risk
21725,22,97,155,274,medium-high-risk
21727,12,108,164,284,medium-high-risk
2173,0,0,0,0,low-risk
21733,0,0,0,0,low-risk
21734,0,0,0,0,low-risk
2174,0,0,0,0,low-risk
21753,0,0,0,0,low-risk
21772,12,150,147,309,medium-high-risk
21775,27,143,214,384,high-risk
2178,0,0,0,0,low-risk
21781,16,138,192,346,high-risk
21802,40,142,217,399,high-risk
2182,12,97,103,212,medium-low-risk
21822,12,127,157,296,medium-high-risk
21826,13,140,188,341,high-risk
21829,0,0,0,0,low-risk
21832,0,0,0,0,low-risk
21835,20,123,158,301,medium-high-risk
21844,0,0,0,0,low-risk
21859,12,141,204,357,high-risk
21887,23,130,187,340,high-risk
21890,29,124,173,326,medium-high-risk
21920,12,124,161,297,medium-high-risk
21921,12,116,119,247,medium-high-risk
21922,30,165,209,404,high-risk
21928,20,153,221,394,high-risk
21937,34,125,172,331,high-risk
21949,12,136,171,319,medium-high-risk
21960,12,155,196,363,high-risk
21962,0,0,0,0,low-risk
21963,0,0,0,0,low-risk
21979,0,0,0,0,low-risk
21987,16,154,203,373,high-risk
21992,12,126,177,315,medium-high-risk
22009,32,94,141,267,medium-high-risk
22010,0,0,0,0,low-risk
22013,0,0,0,0,low-risk
22016,18,119,161,298,medium-high-risk
22020,39,93,202,334,high-risk
22021,16,80,128,224,medium-low-risk
22026,12,153,212,377,high-risk
22033,26,295,189,510,high-risk
22035,12,113,120,245,medium-high-risk
22044,12,133,215,360,high-risk
22046,0,0,0,0,low-risk
22055,0,0,0,0,low-risk
22069,0,0,0,0,low-risk
22071,0,0,0,0,low-risk
22078,13,27,144,184,medium-low-risk
22085,25,83,130,238,medium-low-risk
22087,0,0,0,0,low-risk
22102,0,0,0,0,low-risk
22106,42,170,427,639,high-risk
2211,38,125,164,327,medium-high-risk
22113,0,0,0,0,low-risk
22116,0,0,0,0,low-risk
22121,14,124,148,286,medium-high-risk
2213,17,137,172,326,medium-high-risk
22136,0,0,0,0,low-risk
2214,12,152,215,379,high-risk
22141,12,149,199,360,high-risk
22148,12,102,153,267,medium-high-risk
22149,12,118,93,223,medium-low-risk
22156,0,0,0,0,low-risk
22157,0,0,0,0,low-risk
22158,0,0,0,0,low-risk
22162,0,0,0,0,low-risk
22169,0,0,0,0,low-risk
22179,0,0,0,0,low-risk
22180,0,0,0,0,low-risk
22181,12,143,196,351,high-risk
22188,37,132,156,325,medium-high-risk
22197,0,0,0,0,low-risk
22204,0,0,0,0,low-risk
2221,0,0,0,0,low-risk
22222,12,162,182,356,high-risk
22225,0,0,0,0,low-risk
22228,12,125,157,294,medium-high-risk
22229,19,145,177,341,high-risk
22237,0,0,0,0,low-risk
22243,0,0,0,0,low-risk
22245,12,193,257,462,high-risk
22251,0,0,0,0,low-risk
22253,19,109,149,277,medium-high-risk
22254,0,0,0,0,low-risk
22261,0,0,0,0,low-risk
22266,0,0,0,0,low-risk
22273,0,0,0,0,low-risk
22275,20,152,218,390,high-risk
22276,0,0,0,0,low-risk
22280,0,0,0,0,low-risk
22291,23,159,268,450,high-risk
22296,0,0,0,0,low-risk
22299,12,129,152,293,medium-high-risk
22305,17,92,125,234,medium-low-risk
2231,0,0,0,0,low-risk
22310,0,0,0,0,low-risk
22314,44,145,261,450,high-risk
22315,13,130,175,318,medium-high-risk
22328,12,68,87,167,medium-low-risk
22336,12,124,161,297,medium-high-risk
22341,0,0,0,0,low-risk
22344,0,0,0,0,low-risk
22345,12,107,142,261,medium-high-risk
22351,21,80,136,237,medium-low-risk
2236,20,127,173,320,medium-high-risk
22362,12,70,185,267,medium-high-risk
22368,12,103,131,246,medium-high-risk
22376,0,0,0,0,low-risk
22382,18,98,156,272,medium-high-risk
22386,0,0,0,0,low-risk
22409,0,0,0,0,low-risk
22418,12,149,203,364,high-risk
22425,47,208,262,517,high-risk
22428,0,0,0,0,low-risk
22429,12,110,135,257,medium-high-risk
22432,12,133,173,318,medium-high-risk
22436,0,0,0,0,low-risk
2244,0,0,0,0,low-risk
22440,0,0,0,0,low-risk
22467,0,0,0,0,low-risk
22468,0,0,0,0,low-risk
22473,0,0,0,0,low-risk
22482,17,100,270,387,high-risk
22483,13,109,144,266,medium-high-risk
22487,0,0,0,0,low-risk
2249,12,111,144,267,medium-high-risk
22498,0,0,0,0,low-risk
22499,0,0,0,0,low-risk
22503,12,117,137,266,medium-high-risk
22506,25,144,253,422,high-risk
22520,46,134,254,434,high-risk
22540,12,108,140,260,medium-high-risk
22549,0,0,0,0,low-risk
22550,0,0,0,0,low-risk
22554,13,111,206,330,high-risk
22564,0,0,0,0,low-risk
22567,33,124,155,312,medium-high-risk
22576,0,0,0,0,low-risk
2258,27,135,216,378,high-risk
22585,0,0,0,0,low-risk
22589,0,0,0,0,low-risk
22592,0,0,0,0,low-risk
22598,12,219,137,368,high-risk
2260,15,100,160,275,medium-high-risk
22601,0,0,0,0,low-risk
22607,12,129,156,297,medium-high-risk
22608,0,0,0,0,low-risk
22616,0,0,0,0,low-risk
22622,12,95,125,232,medium-low-risk
22627,12,137,154,303,medium-high-risk
22629,12,133,130,275,medium-high-risk
22633,0,0,0,0,low-risk
22634,0,0,0,0,low-risk
22635,0,0,0,0,low-risk
22636,0,0,0,0,low-risk
22642,0,0,0,0,low-risk
22673,0,0,0,0,low-risk
22683,12,145,134,291,medium-high-risk
22685,0,0,0,0,low-risk
22691,0,0,0,0,low-risk
22701,0,0,0,0,low-risk
22710,0,0,0,0,low-risk
22725,22,148,176,346,high-risk
22726,0,0,0,0,low-risk
2274,29,151,311,491,high-risk
22741,12,155,177,344,high-risk
22749,21,188,296,505,high-risk
22751,12,77,124,213,medium-low-risk
22772,0,0,0,0,low-risk
22778,12,137,167,316,medium-high-risk
22779,0,0,0,0,low-risk
22780,0,0,0,0,low-risk
22783,0,0,0,0,low-risk
22786,12,89,120,221,medium-low-risk
22802,0,0,0,0,low-risk
22805,0,0,0,0,low-risk
22814,29,188,261,478,high-risk
22820,0,0,0,0,low-risk
22824,58,163,225,446,high-risk
22828,42,131,169,342,high-risk
22835,12,82,117,211,medium-low-risk
22848,12,83,100,195,medium-low-risk
22849,39,130,182,351,high-risk
2285,0,0,0,0,low-risk
2286,0,0,0,0,low-risk
22861,31,138,175,344,high-risk
22869,0,0,0,0,low-risk
22871,12,145,165,322,medium-high-risk
22873,17,139,276,432,high-risk
22877,37,170,207,414,high-risk
2288,14,93,146,253,medium-high-risk
22884,27,178,260,465,high-risk
22911,0,0,0,0,low-risk
22916,12,104,159,275,medium-high-risk
22917,24,100,137,261,medium-high-risk
22923,0,0,0,0,low-risk
22937,14,90,118,222,medium-low-risk
2294,12,138,184,334,high-risk
22944,0,0,0,0,low-risk
22950,15,141,252,408,high-risk
22976,12,148,184,344,high-risk
2298,0,0,0,0,low-risk
22984,12,113,218,343,high-risk
22985,12,120,143,275,medium-high-risk
22993,0,0,0,0,low-risk
23000,30,105,167,302,medium-high-risk
23004,12,142,184,338,high-risk
23007,36,145,206,387,high-risk
23010,12,90,111,213,medium-low-risk
23013,0,0,0,0,low-risk
23016,0,0,0,0,low-risk
23019,17,115,156,288,medium-high-risk
23029,13,140,175,328,medium-high-risk
23033,0,0,0,0,low-risk
23047,12,141,162,315,medium-high-risk
23056,18,142,180,340,high-risk
2306,12,116,162,290,medium-high-risk
23062,0,0,0,0,low-risk
23067,21,149,206,376,high-risk
23074,0,0,0,0,low-risk
23076,12,124,137,273,medium-high-risk
23078,12,106,171,289,medium-high-risk
2308,12,183,130,325,medium-high-risk
23086,33,127,180,340,high-risk
23090,12,106,134,252,medium-high-risk
23095,0,0,0,0,low-risk
23096,0,0,0,0,low-risk
23110,19,113,174,306,medium-high-risk
23119,27,136,186,349,high-risk
23130,12,137,174,323,medium-high-risk
23139,0,0,0,0,low-risk
23145,12,166,222,400,high-risk
2315,25,138,198,361,high-risk
23151,12,147,183,342,high-risk
23154,0,0,0,0,low-risk
23157,0,0,0,0,low-risk
23162,12,123,151,286,medium-high-risk
2317,0,0,0,0,low-risk
23173,0,0,0,0,low-risk
23181,12,136,166,314,medium-high-risk
23185,32,147,215,394,high-risk
23188,0,0,0,0,low-risk
23192,16,87,144,247,medium-high-risk
23195,0,0,0,0,low-risk
23197,0,0,0,0,low-risk
23200,0,0,0,0,low-risk
23229,12,123,176,311,medium-high-risk
23230,19,147,205,371,high-risk
23234,15,139,161,315,medium-high-risk
23239,0,0,0,0,low-risk
23240,16,99,120,235,medium-low-risk
23247,0,0,0,0,low-risk
2325,0,0,0,0,low-risk
23251,0,0,0,0,low-risk
23263,0,0,0,0,low-risk
23265,12,79,145,236,medium-low-risk
23275,23,98,190,311,medium-high-risk
23284,0,0,0,0,low-risk
23289,0,0,0,0,low-risk
23290,23,172,177,372,high-risk
23296,12,151,204,367,high-risk
23297,0,0,0,0,low-risk
23298,12,122,129,263,medium-high-risk
23306,31,145,205,381,high-risk
2331,12,179,474,665,high-risk
23310,0,0,0,0,low-risk
23311,13,97,134,244,medium-low-risk
23314,36,131,229,396,high-risk
23326,0,0,0,0,low-risk
23329,15,123,154,292,medium-high-risk
23336,14,126,209,349,high-risk
23344,0,0,0,0,low-risk
23348,12,151,178,341,high-risk
23369,11,155,223,389,high-risk
23376,0,0,0,0,low-risk
23387,19,158,223,400,high-risk
23393,18,108,165,291,medium-high-risk
23400,0,0,0,0,low-risk
23425,12,113,140,265,medium-high-risk
23428,39,147,203,389,high-risk
23437,11,111,127,249,medium-high-risk
23448,17,134,178,329,medium-high-risk
23456,12,175,218,405,high-risk
23466,14,66,127,207,medium-low-risk
23479,23,144,210,377,high-risk
23480,0,0,0,0,low-risk
23486,29,133,186,348,high-risk
23488,0,0,0,0,low-risk
23500,0,0,0,0,low-risk
23502,17,157,187,361,high-risk
23514,13,110,217,340,high-risk
2352,0,0,0,0,low-risk
23521,41,113,211,365,high-risk
23546,37,117,174,328,medium-high-risk
23552,0,0,0,0,low-risk
23561,12,153,205,370,high-risk
23570,0,0,0,0,low-risk
23572,19,96,144,259,medium-high-risk
23579,21,147,170,338,high-risk
23585,15,192,134,341,high-risk
23590,12,134,178,324,medium-high-risk
23598,24,134,185,343,high-risk
23602,0,0,0,0,low-risk
23604,0,0,0,0,low-risk
23607,12,79,116,207,medium-low-risk
23612,18,85,128,231,medium-low-risk
23613,12,119,185,316,medium-high-risk
23614,0,0,0,0,low-risk
23619,0,0,0,0,low-risk
23625,12,139,157,308,medium-high-risk
23634,0,0,0,0,low-risk
23637,24,168,216,408,high-risk
23639,0,0,0,0,low-risk
2364,0,0,0,0,low-risk
23650,0,0,0,0,low-risk
23652,16,134,213,363,high-risk
23655,0,0,0,0,low-risk
23668,0,0,0,0,low-risk
23671,12,121,144,277,medium-high-risk
23682,0,0,0,0,low-risk
23685,12,131,146,289,medium-high-risk
2369,12,127,144,283,medium-high-risk
23700,11,102,133,246,medium-high-risk
23706,15,123,179,317,medium-high-risk
23714,12,165,198,375,high-risk
23718,35,183,256,474,high-risk
23727,45,175,330,550,high-risk
23733,12,148,308,468,high-risk
23740,25,140,187,352,high-risk
23746,0,0,0,0,low-risk
23748,30,172,223,425,high-risk
23754,12,120,179,311,medium-high-risk
23759,0,0,0,0,low-risk
23776,32,133,188,353,high-risk
23782,12,132,128,272,medium-high-risk
23792,0,0,0,0,low-risk
23793,12,169,210,391,high-risk
23805,12,97,111,220,medium-low-risk
23819,17,125,169,311,medium-high-risk
23821,0,0,0,0,low-risk
23824,19,100,144,263,medium-high-risk
23827,0,0,0,0,low-risk
23829,0,0,0,0,low-risk
23832,0,0,0,0,low-risk
23835,0,0,0,0,low-risk
23836,14,115,214,343,high-risk
23839,12,154,182,348,high-risk
23846,12,136,200,348,high-risk
23849,30,102,163,295,medium-high-risk
2386,0,0,0,0,low-risk
23861,0,0,0,0,low-risk
23863,0,0,0,0,low-risk
23864,0,0,0,0,low-risk
23866,26,112,153,291,medium-high-risk
2387,30,131,189,350,high-risk
23872,30,160,251,441,high-risk
23874,0,0,0,0,low-risk
23880,0,0,0,0,low-risk
23883,20,134,179,333,high-risk
23885,0,0,0,0,low-risk
23896,32,113,178,323,medium-high-risk
2390,16,205,269,490,high-risk
23906,12,140,155,307,medium-high-risk
23907,42,118,175,335,high-risk
23909,17,123,165,305,medium-high-risk
23913,0,0,0,0,low-risk
23933,0,0,0,0,low-risk
23936,25,131,206,362,high-risk
23948,0,0,0,0,low-risk
23949,0,0,0,0,low-risk
23951,12,140,202,354,high-risk
23958,16,127,204,347,high-risk
23961,0,0,0,0,low-risk
23969,35,172,293,500,high-risk
2397,0,0,0,0,low-risk
23970,56,145,279,480,high-risk
23972,13,149,225,387,high-risk
23975,0,0,0,0,low-risk
23977,0,0,0,0,low-risk
23978,15,115,199,329,medium-high-risk
23981,12,229,174,415,high-risk
23982,33,126,198,357,high-risk
2399,0,0,0,0,low-risk
23991,13,110,137,260,medium-high-risk
24009,37,240,223,500,high-risk
24013,12,147,196,355,high-risk
24015,0,0,0,0,low-risk
24020,0,0,0,0,low-risk
24024,12,102,142,256,medium-high-risk
24030,35,118,150,303,medium-high-risk
24032,12,119,140,271,medium-high-risk
24033,55,155,299,509,high-risk
24035,18,86,111,215,medium-low-risk
24043,0,0,0,0,low-risk
24053,15,82,131,228,medium-low-risk
24059,25,127,181,333,high-risk
24067,0,0,0,0,low-risk
24084,0,0,0,0,low-risk
2409,0,0,0,0,low-risk
24095,30,126,201,357,high-risk
24100,0,0,0,0,low-risk
24101,0,0,0,0,low-risk
24110,17,93,127,237,medium-low-risk
24111,0,0,0,0,low-risk
24112,12,59,100,171,medium-low-risk
24125,0,0,0,0,low-risk
24128,12,118,162,292,medium-high-risk
24131,0,0,0,0,low-risk
24138,19,105,151,275,medium-high-risk
24139,0,0,0,0,low-risk
24146,0,0,0,0,low-risk
24148,0,0,0,0,low-risk
24161,0,0,0,0,low-risk
24168,0,0,0,0,low-risk
24172,0,0,0,0,low-risk
24185,12,118,157,287,medium-high-risk
24186,12,102,163,277,medium-high-risk
24193,26,136,175,337,high-risk
24196,0,0,0,0,low-risk
24198,36,121,244,401,high-risk
24202,15,92,135,242,medium-low-risk
24206,0,0,0,0,low-risk
24211,12,131,147,290,medium-high-risk
24217,12,116,120,248,medium-high-risk
24221,12,124,145,281,medium-high-risk
24223,12,111,131,254,medium-high-risk
24230,24,145,191,360,high-risk
24232,29,133,180,342,high-risk
24237,13,150,238,401,high-risk
24240,0,0,0,0,low-risk
24247,12,128,154,294,medium-high-risk
24248,0,0,0,0,low-risk
24252,12,165,177,354,high-risk
24254,12,146,163,321,medium-high-risk
24265,0,0,0,0,low-risk
24271,12,93,139,244,medium-low-risk
24273,0,0,0,0,low-risk
24278,13,147,246,406,high-risk
24291,12,120,131,263,medium-high-risk
24295,0,0,0,0,low-risk
2430,12,156,175,343,high-risk
24301,12,126,185,323,medium-high-risk
24310,0,0,0,0,low-risk
24342,0,0,0,0,low-risk
24343,21,143,173,337,high-risk
24363,0,0,0,0,low-risk
24365,12,151,185,348,high-risk
24368,0,0,0,0,low-risk
24375,32,209,217,458,high-risk
24380,12,117,141,270,medium-high-risk
24385,0,0,0,0,low-risk
24398,13,124,179,316,medium-high-risk
2440,12,81,122,215,medium-low-risk
2441,0,0,0,0,low-risk
24437,0,0,0,0,low-risk
24441,18,80,140,238,medium-low-risk
24449,28,160,209,397,high-risk
24452,0,0,0,0,low-risk
24458,0,0,0,0,low-risk
2446,20,90,135,245,medium-high-risk
24466,0,0,0,0,low-risk
24469,12,127,154,293,medium-high-risk
24475,14,165,217,396,high-risk
24476,18,159,182,359,high-risk
24488,0,0,0,0,low-risk
24492,0,0,0,0,low-risk
24495,12,104,192,308,medium-high-risk
24500,0,0,0,0,low-risk
24515,13,123,160,296,medium-high-risk
24532,0,0,0,0,low-risk
24540,16,155,246,417,high-risk
24544,22,125,166,313,medium-high-risk
24547,12,125,165,302,medium-high-risk
24559,0,0,0,0,low-risk
24570,17,111,147,275,medium-high-risk
24571,12,150,201,363,high-risk
24575,27,170,262,459,high-risk
24576,12,125,159,296,medium-high-risk
24589,0,0,0,0,low-risk
24592,12,154,182,348,high-risk
24597,0,0,0,0,low-risk
24600,12,140,297,449,high-risk
24602,12,113,143,268,medium-high-risk
24606,12,189,217,418,high-risk
24613,0,0,0,0,low-risk
24618,15,180,288,483,high-risk
24620,0,0,0,0,low-risk
24629,28,82,121,231,medium-low-risk
24636,0,0,0,0,low-risk
24639,12,105,118,235,medium-low-risk
24641,12,101,138,251,medium-high-risk
24643,0,0,0,0,low-risk
24656,0,0,0,0,low-risk
24658,30,142,185,357,high-risk
24663,13,105,138,256,medium-high-risk
24674,0,0,0,0,low-risk
24676,12,162,169,343,high-risk
24677,21,99,189,309,medium-high-risk
24681,0,0,0,0,low-risk
24689,12,105,124,241,medium-low-risk
24698,33,116,233,382,high-risk
24699,0,0,0,0,low-risk
24714,12,99,126,237,medium-low-risk
24719,38,135,170,343,high-risk
24723,0,0,0,0,low-risk
24726,12,131,166,309,medium-high-risk
24731,26,157,192,375,high-risk
24733,12,146,155,313,medium-high-risk
24739,52,158,232,442,high-risk
24745,0,0,0,0,low-risk
24753,12,177,212,401,high-risk
24757,11,99,132,242,medium-low-risk
24760,15,85,131,231,medium-low-risk
24766,29,152,243,424,high-risk
24775,0,0,0,0,low-risk
24778,17,84,132,233,medium-low-risk
24787,12,134,143,289,medium-high-risk
24796,16,114,187,317,medium-high-risk
24803,12,111,153,276,medium-high-risk
2481,0,0,0,0,low-risk
24815,12,146,282,440,high-risk
24830,0,0,0,0,low-risk
24831,12,128,62,202,medium-low-risk
24833,0,0,0,0,low-risk
24836,0,0,0,0,low-risk
24842,18,105,135,258,medium-high-risk
24848,12,162,175,349,high-risk
24849,12,103,143,258,medium-high-risk
2486,12,104,159,275,medium-high-risk
24860,12,133,135,280,medium-high-risk
24867,12,144,184,340,high-risk
2487,13,132,227,372,high-risk
24882,20,149,161,330,high-risk
24889,12,107,137,256,medium-high-risk
24890,43,150,295,488,high-risk
24897,0,0,0,0,low-risk
24903,13,139,196,348,high-risk
24910,0,0,0,0,low-risk
24920,12,88,98,198,medium-low-risk
24922,0,0,0,0,low-risk
2493,12,123,213,348,high-risk
24931,12,152,192,356,high-risk
24932,0,0,0,0,low-risk
24935,0,0,0,0,low-risk
24945,0,0,0,0,low-risk
24951,0,0,0,0,low-risk
24954,30,186,258,474,high-risk
24958,0,0,0,0,low-risk
24960,20,166,188,374,high-risk
24962,0,0,0,0,low-risk
24964,12,116,151,279,medium-high-risk
24966,12,141,169,322,medium-high-risk
24967,0,0,0,0,low-risk
24968,0,0,0,0,low-risk
24987,0,0,0,0,low-risk
24988,29,135,173,337,high-risk
24990,30,169,222,421,high-risk
25011,12,125,174,311,medium-high-risk
25014,0,0,0,0,low-risk
25015,12,177,194,383,high-risk
25017,0,0,0,0,low-risk
25018,0,0,0,0,low-risk
25032,21,154,205,380,high-risk
25040,26,124,145,295,medium-high-risk
25046,33,196,256,485,high-risk
25049,0,0,0,0,low-risk
25050,12,113,144,269,medium-high-risk
25058,0,0,0,0,low-risk
25075,0,0,0,0,low-risk
25080,12,98,134,244,medium-low-risk
25083,0,0,0,0,low-risk
25093,28,165,220,413,high-risk
25097,12,128,168,308,medium-high-risk
25098,12,141,104,257,medium-high-risk
25103,0,0,0,0,low-risk
25106,12,96,144,252,medium-high-risk
25108,0,0,0,0,low-risk
25115,25,96,172,293,medium-high-risk
25117,28,127,200,355,high-risk
25120,32,168,213,413,high-risk
25125,17,128,206,351,high-risk
25138,0,0,0,0,low-risk
25153,12,140,157,309,medium-high-risk
25155,18,80,143,241,medium-low-risk
25162,23,193,271,487,high-risk
25168,12,99,153,264,medium-high-risk
25171,0,0,0,0,low-risk
2518,20,180,248,448,high-risk
25182,0,0,0,0,low-risk
25185,23,75,145,243,medium-low-risk
25190,0,0,0,0,low-risk
25192,12,146,211,369,high-risk
25195,0,0,0,0,low-risk
25198,12,85,100,197,medium-low-risk
25202,12,90,114,216,medium-low-risk
25209,12,104,127,243,medium-low-risk
25210,30,95,162,287,medium-high-risk
25212,31,143,172,346,high-risk
25213,0,0,0,0,low-risk
25217,0,0,0,0,low-risk
25218,0,0,0,0,low-risk
25219,12,102,137,251,medium-high-risk
25225,0,0,0,0,low-risk
25233,12,99,115,226,medium-low-risk
25237,0,0,0,0,low-risk
25238,0,0,0,0,low-risk
25240,44,161,219,424,high-risk
2525,0,0,0,0,low-risk
25253,13,100,140,253,medium-high-risk
25254,0,0,0,0,low-risk
25267,0,0,0,0,low-risk
25275,0,0,0,0,low-risk
2528,12,135,159,306,medium-high-risk
25284,0,0,0,0,low-risk
25286,35,175,222,432,high-risk
2529,0,0,0,0,low-risk
25304,12,136,154,302,medium-high-risk
25305,12,116,148,276,medium-high-risk
25306,0,0,0,0,low-risk
25307,11,165,218,394,high-risk
25319,0,0,0,0,low-risk
25330,12,160,202,374,high-risk
25359,0,0,0,0,low-risk
25361,12,148,186,346,high-risk
25362,12,125,214,351,high-risk
25365,29,91,142,262,medium-high-risk
25368,0,0,0,0,low-risk
2538,12,147,158,317,medium-high-risk
25390,0,0,0,0,low-risk
25399,12,112,155,279,medium-high-risk
25412,22,112,161,295,medium-high-risk
25413,0,0,0,0,low-risk
25415,14,175,260,449,high-risk
25429,34,140,306,480,high-risk
25439,0,0,0,0,low-risk
25447,0,0,0,0,low-risk
25450,12,152,176,340,high-risk
25451,53,111,269,433,high-risk
25453,12,44,80,136,medium-low-risk
25462,0,0,0,0,low-risk
25480,12,107,118,237,medium-low-risk
25485,36,116,173,325,medium-high-risk
25487,0,0,0,0,low-risk
25503,15,158,211,384,high-risk
25505,14,175,234,423,high-risk
25510,27,146,178,351,high-risk
25513,12,151,154,317,medium-high-risk
25518,42,130,184,356,high-risk
25530,0,0,0,0,low-risk
25539,12,80,105,197,medium-low-risk
25543,12,159,177,348,high-risk
25551,14,130,213,357,high-risk
25555,0,0,0,0,low-risk
25574,12,119,161,292,medium-high-risk
25584,15,124,171,310,medium-high-risk
25586,14,108,161,283,medium-high-risk
25589,12,86,132,230,medium-low-risk
25594,39,114,158,311,medium-high-risk
25610,0,0,0,0,low-risk
25613,12,164,191,367,high-risk
25615,12,137,236,385,high-risk
25630,14,311,279,604,high-risk
25631,12,113,119,244,medium-low-risk
25637,12,127,146,285,medium-high-risk
25639,12,145,216,373,high-risk
25646,12,101,132,245,medium-high-risk
25649,12,120,141,273,medium-high-risk
25652,3,23,256,282,medium-high-risk
25654,12,122,227,361,high-risk
25657,15,103,138,256,medium-high-risk
25668,0,0,0,0,low-risk
25685,12,129,133,274,medium-high-risk
25687,0,0,0,0,low-risk
25691,12,150,172,334,high-risk
25693,0,0,0,0,low-risk
25696,19,142,163,324,medium-high-risk
25697,0,0,0,0,low-risk
25711,35,126,176,337,high-risk
25714,23,101,141,265,medium-high-risk
25716,41,124,159,324,medium-high-risk
25717,0,0,0,0,low-risk
25718,13,131,310,454,high-risk
2574,23,144,246,413,high-risk
25745,12,87,130,229,medium-low-risk
25747,0,0,0,0,low-risk
25756,13,172,237,422,high-risk
25758,13,133,246,392,high-risk
25769,0,0,0,0,low-risk
25772,0,0,0,0,low-risk
25778,19,166,211,396,high-risk
25779,26,147,183,356,high-risk
25781,23,121,191,335,high-risk
25793,0,0,0,0,low-risk
25798,12,102,129,243,medium-low-risk
2580,12,132,151,295,medium-high-risk
25803,0,0,0,0,low-risk
25805,0,0,0,0,low-risk
25807,12,120,161,293,medium-high-risk
25812,33,112,166,311,medium-high-risk
25834,20,89,118,227,medium-low-risk
25835,0,0,0,0,low-risk
25837,12,153,161,326,medium-high-risk
25838,29,117,202,348,high-risk
25840,0,0,0,0,low-risk
2585,12,131,139,282,medium-high-risk
25856,0,0,0,0,low-risk
25859,18,201,157,376,high-risk
25860,12,100,128,240,medium-low-risk
25866,37,106,170,313,medium-high-risk
25867,18,94,149,261,medium-high-risk
25901,12,149,161,322,medium-high-risk
25906,46,133,184,363,high-risk
25908,29,141,185,355,high-risk
25915,0,0,0,0,low-risk
25919,0,0,0,0,low-risk
2592,0,0,0,0,low-risk
25927,0,0,0,0,low-risk
25930,12,94,138,244,medium-low-risk
25933,12,77,101,190,medium-low-risk
25942,12,86,117,215,medium-low-risk
25943,0,0,0,0,low-risk
25945,12,121,153,286,medium-high-risk
2595,0,0,0,0,low-risk
25965,12,75,119,206,medium-low-risk
25975,12,151,276,439,high-risk
25990,13,106,154,273,medium-high-risk
25997,51,123,205,379,high-risk
26003,24,169,205,398,high-risk
26004,0,0,0,0,low-risk
26014,0,0,0,0,low-risk
26015,0,0,0,0,low-risk
26016,12,61,100,173,medium-low-risk
26023,0,0,0,0,low-risk
26029,0,0,0,0,low-risk
26047,12,98,150,260,medium-high-risk
26052,12,121,136,269,medium-high-risk
26061,12,113,134,259,medium-high-risk
26075,0,0,0,0,low-risk
26078,0,0,0,0,low-risk
26088,0,0,0,0,low-risk
26091,17,239,186,442,high-risk
26099,0,0,0,0,low-risk
26108,0,0,0,0,low-risk
26121,0,0,0,0,low-risk
26127,12,143,170,325,medium-high-risk
26146,15,126,196,337,high-risk
26149,17,134,172,323,medium-high-risk
26150,12,98,204,314,medium-high-risk
26160,0,0,0,0,low-risk
26170,12,139,162,313,medium-high-risk
26173,57,156,256,469,high-risk
26176,16,95,139,250,medium-high-risk
26178,0,0,0,0,low-risk
26182,0,0,0,0,low-risk
26197,14,110,159,283,medium-high-risk
26230,12,107,145,264,medium-high-risk
26232,48,190,252,490,high-risk
26242,11,110,233,354,high-risk
26244,12,141,161,314,medium-high-risk
26246,0,0,0,0,low-risk
26258,12,86,133,231,medium-low-risk
2626,0,0,0,0,low-risk
26262,12,119,168,299,medium-high-risk
26263,19,79,117,215,medium-low-risk
26278,12,182,215,409,high-risk
26316,13,116,118,247,medium-high-risk
2632,17,106,123,246,medium-high-risk
26321,0,0,0,0,low-risk
26322,17,109,169,295,medium-high-risk
26334,0,0,0,0,low-risk
26340,0,0,0,0,low-risk
26372,0,0,0,0,low-risk
26374,12,134,184,330,high-risk
26380,0,0,0,0,low-risk
26384,0,0,0,0,low-risk
26390,12,89,99,200,medium-low-risk
26395,0,0,0,0,low-risk
26397,12,91,126,229,medium-low-risk
2641,12,150,173,335,high-risk
26413,12,139,194,345,high-risk
26416,0,0,0,0,low-risk
26438,0,0,0,0,low-risk
26439,24,120,189,333,high-risk
26447,14,144,203,361,high-risk
26448,0,0,0,0,low-risk
26463,0,0,0,0,low-risk
26464,26,137,283,446,high-risk
2647,12,127,165,304,medium-high-risk
26470,12,106,219,337,high-risk
26475,37,125,174,336,high-risk
26485,0,0,0,0,low-risk
26499,12,105,136,253,medium-high-risk
26504,0,0,0,0,low-risk
26506,0,0,0,0,low-risk
26507,13,137,168,318,medium-high-risk
26508,26,99,138,263,medium-high-risk
26511,0,0,0,0,low-risk
26513,0,0,0,0,low-risk
26523,11,124,198,333,high-risk
26524,12,96,193,301,medium-high-risk
26534,12,168,251,431,high-risk
26536,41,111,193,345,high-risk
26542,12,170,192,374,high-risk
26543,0,0,0,0,low-risk
26558,12,116,164,292,medium-high-risk
26568,40,170,193,403,high-risk
26599,0,0,0,0,low-risk
26603,0,0,0,0,low-risk
26605,0,0,0,0,low-risk
2663,57,154,234,445,high-risk
26630,19,91,135,245,medium-high-risk
26646,12,141,87,240,medium-low-risk
26650,0,0,0,0,low-risk
26652,12,110,154,276,medium-high-risk
2666,35,140,195,370,high-risk
26660,0,0,0,0,low-risk
26663,0,0,0,0,low-risk
26673,0,0,0,0,low-risk
26675,0,0,0,0,low-risk
26688,12,143,176,331,high-risk
26695,0,0,0,0,low-risk
26714,12,122,173,307,medium-high-risk
26731,12,149,179,340,high-risk
26736,0,0,0,0,low-risk
26737,12,137,159,308,medium-high-risk
26747,0,0,0,0,low-risk
2677,26,134,175,335,high-risk
26774,0,0,0,0,low-risk
26797,0,0,0,0,low-risk
26805,12,125,153,290,medium-high-risk
26808,0,0,0,0,low-risk
26809,0,0,0,0,low-risk
26812,0,0,0,0,low-risk
26813,12,117,157,286,medium-high-risk
26814,21,149,228,398,high-risk
26819,13,128,172,313,medium-high-risk
26824,12,138,89,239,medium-low-risk
26831,0,0,0,0,low-risk
26842,12,98,151,261,medium-high-risk
26846,59,162,232,453,high-risk
26847,18,77,117,212,medium-low-risk
26856,0,0,0,0,low-risk
26880,0,0,0,0,low-risk
26888,0,0,0,0,low-risk
26890,32,191,313,536,high-risk
26903,0,0,0,0,low-risk
26906,0,0,0,0,low-risk
26922,0,0,0,0,low-risk
26937,16,136,189,341,high-risk
26955,13,94,129,236,medium-low-risk
26969,45,153,205,403,high-risk
26982,0,0,0,0,low-risk
26992,0,0,0,0,low-risk
27001,0,0,0,0,low-risk
27002,0,0,0,0,low-risk
27006,22,100,147,269,medium-high-risk
27028,0,0,0,0,low-risk
27035,14,89,129,232,medium-low-risk
27036,0,0,0,0,low-risk
27046,12,88,141,241,medium-low-risk
27055,0,0,0,0,low-risk
27062,12,115,126,253,medium-high-risk
27082,12,126,170,308,medium-high-risk
27089,0,0,0,0,low-risk
27093,0,0,0,0,low-risk
2710,12,109,131,252,medium-high-risk
2711,32,135,164,331,high-risk
27111,0,0,0,0,low-risk
27124,12,139,158,309,medium-high-risk
27134,18,102,146,266,medium-high-risk
27135,12,135,170,317,medium-high-risk
2714,0,0,0,0,low-risk
27145,12,241,229,482,high-risk
27149,0,0,0,0,low-risk
27151,12,109,156,277,medium-high-risk
27168,14,97,148,259,medium-high-risk
27171,12,94,105,211,medium-low-risk
27173,12,126,137,275,medium-high-risk
2718,0,0,0,0,low-risk
27180,12,115,147,274,medium-high-risk
27184,0,0,0,0,low-risk
2719,12,146,191,349,high-risk
27196,0,0,0,0,low-risk
27197,28,101,155,284,medium-high-risk
27204,14,145,175,334,high-risk
27207,0,0,0,0,low-risk
27222,0,0,0,0,low-risk
27223,27,91,143,261,medium-high-risk
27251,0,0,0,0,low-risk
27266,12,120,159,291,medium-high-risk
27285,0,0,0,0,low-risk
27287,12,133,156,301,medium-high-risk
27290,0,0,0,0,low-risk
27292,19,104,144,267,medium-high-risk
27295,12,105,117,234,medium-low-risk
27296,17,119,216,352,high-risk
27300,14,136,216,366,high-risk
27308,25,151,204,380,high-risk
27327,0,0,0,0,low-risk
27331,12,99,111,222,medium-low-risk
27333,13,127,165,305,medium-high-risk
27338,12,122,156,290,medium-high-risk
27342,23,146,180,349,high-risk
27348,0,0,0,0,low-risk
27354,0,0,0,0,low-risk
27355,12,119,162,293,medium-high-risk
27372,12,131,108,251,medium-high-risk
27389,0,0,0,0,low-risk
27399,45,114,309,468,high-risk
27402,19,67,105,191,medium-low-risk
27406,19,115,143,277,medium-high-risk
27409,25,124,199,348,high-risk
27411,12,123,156,291,medium-high-risk
27413,0,0,0,0,low-risk
27422,47,183,240,470,high-risk
27425,12,90,125,227,medium-low-risk
27427,0,0,0,0,low-risk
27430,0,0,0,0,low-risk
27443,0,0,0,0,low-risk
27459,12,101,204,317,medium-high-risk
27467,12,112,153,277,medium-high-risk
27475,0,0,0,0,low-risk
27485,0,0,0,0,low-risk
27522,14,100,150,264,medium-high-risk
27527,0,0,0,0,low-risk
27547,26,100,128,254,medium-high-risk
27548,23,98,135,256,medium-high-risk
27550,20,168,209,397,high-risk
27552,12,99,136,247,medium-high-risk
27555,15,127,207,349,high-risk
2756,0,0,0,0,low-risk
27565,0,0,0,0,low-risk
27574,0,0,0,0,low-risk
27575,12,162,184,358,high-risk
27577,0,0,0,0,low-risk
27583,0,0,0,0,low-risk
27585,12,120,129,261,medium-high-risk
27594,34,121,161,316,medium-high-risk
2760,22,108,163,293,medium-high-risk
27606,0,0,0,0,low-risk
27618,12,131,172,315,medium-high-risk
27628,24,75,139,238,medium-low-risk
27635,0,0,0,0,low-risk
27639,0,0,0,0,low-risk
27641,12,140,153,305,medium-high-risk
27649,12,173,245,430,high-risk
27650,40,155,204,399,high-risk
27655,30,114,152,296,medium-high-risk
27659,0,0,0,0,low-risk
27661,33,127,185,345,high-risk
27662,12,149,216,377,high-risk
2767,15,221,143,379,high-risk
27678,12,265,190,467,high-risk
27696,0,0,0,0,low-risk
27697,33,129,167,329,medium-high-risk
27700,33,152,207,392,high-risk
27704,14,101,115,230,medium-low-risk
2771,12,157,182,351,high-risk
27722,0,0,0,0,low-risk
27741,0,0,0,0,low-risk
27746,14,134,202,350,high-risk
27758,14,153,198,365,high-risk
2778,51,162,200,413,high-risk
27780,0,0,0,0,low-risk
27784,12,134,266,412,high-risk
27789,0,0,0,0,low-risk
2779,11,155,193,359,high-risk
27794,16,77,110,203,medium-low-risk
27796,0,0,0,0,low-risk
27798,0,0,0,0,low-risk
27801,12,127,161,300,medium-high-risk
27810,0,0,0,0,low-risk
27826,21,186,233,440,high-risk
27838,0,0,0,0,low-risk
27845,0,0,0,0,low-risk
27860,12,87,138,237,medium-low-risk
27861,0,0,0,0,low-risk
27867,14,89,207,310,medium-high-risk
27872,19,85,126,230,medium-low-risk
27887,16,139,235,390,high-risk
27892,18,111,168,297,medium-high-risk
27895,12,145,150,307,medium-high-risk
27899,12,168,184,364,high-risk
27903,12,121,167,300,medium-high-risk
27906,0,0,0,0,low-risk
27940,31,130,168,329,medium-high-risk
27941,15,140,171,326,medium-high-risk
27945,0,0,0,0,low-risk
27948,0,0,0,0,low-risk
2795,12,173,202,387,high-risk
27951,0,0,0,0,low-risk
27958,0,0,0,0,low-risk
27971,12,127,142,281,medium-high-risk
27975,39,137,191,367,high-risk
27979,12,122,162,296,medium-high-risk
27983,26,104,309,439,high-risk
27989,0,0,0,0,low-risk
27990,16,143,139,298,medium-high-risk
28029,0,0,0,0,low-risk
28030,0,0,0,0,low-risk
28032,35,129,188,352,high-risk
28035,0,0,0,0,low-risk
28054,0,0,0,0,low-risk
28056,12,117,172,301,medium-high-risk
28061,0,0,0,0,low-risk
28068,0,0,0,0,low-risk
28074,0,0,0,0,low-risk
28078,0,0,0,0,low-risk
28085,17,131,178,326,medium-high-risk
28095,19,105,145,269,medium-high-risk
28118,0,0,0,0,low-risk
28124,0,0,0,0,low-risk
28135,0,0,0,0,low-risk
28155,12,152,163,327,medium-high-risk
2817,43,133,409,585,high-risk
28173,18,82,136,236,medium-low-risk
28181,12,99,125,236,medium-low-risk
28225,12,117,165,294,medium-high-risk
28234,14,151,226,391,high-risk
28242,19,97,119,235,medium-low-risk
28247,26,107,157,290,medium-high-risk
28251,12,169,215,396,high-risk
28260,0,0,0,0,low-risk
28269,0,0,0,0,low-risk
28272,12,151,253,416,high-risk
28287,12,88,107,207,medium-low-risk
28288,25,111,138,274,medium-high-risk
28295,0,0,0,0,low-risk
28306,0,0,0,0,low-risk
28313,12,121,161,294,medium-high-risk
28316,27,133,166,326,medium-high-risk
28325,0,0,0,0,low-risk
28329,12,128,144,284,medium-high-risk
2833,0,0,0,0,low-risk
28335,0,0,0,0,low-risk
28341,0,0,0,0,low-risk
28355,0,0,0,0,low-risk
28358,0,0,0,0,low-risk
2836,0,0,0,0,low-risk
28364,0,0,0,0,low-risk
28366,13,119,152,284,medium-high-risk
28378,0,0,0,0,low-risk
2838,12,99,100,211,medium-low-risk
28381,12,143,169,324,medium-high-risk
28386,24,116,146,286,medium-high-risk
28390,0,0,0,0,low-risk
28391,19,160,219,398,high-risk
28399,12,116,140,268,medium-high-risk
28415,0,0,0,0,low-risk
28419,0,0,0,0,low-risk
28420,12,139,164,315,medium-high-risk
2844,12,105,144,261,medium-high-risk
28440,0,0,0,0,low-risk
28441,20,120,225,365,high-risk
28442,12,130,172,314,medium-high-risk
28445,12,96,109,217,medium-low-risk
28448,12,143,182,337,high-risk
2846,0,0,0,0,low-risk
28474,12,137,155,304,medium-high-risk
28476,28,167,211,406,high-risk
28477,0,0,0,0,low-risk
28479,12,116,139,267,medium-high-risk
2848,0,0,0,0,low-risk
28484,0,0,0,0,low-risk
28492,18,86,121,225,medium-low-risk
28498,0,0,0,0,low-risk
28510,0,0,0,0,low-risk
28513,12,135,157,304,medium-high-risk
28516,12,125,135,272,medium-high-risk
2852,28,127,200,355,high-risk
28520,0,0,0,0,low-risk
28521,13,148,205,366,high-risk
2853,0,0,0,0,low-risk
2854,12,128,162,302,medium-high-risk
28542,12,133,215,360,high-risk
28546,0,0,0,0,low-risk
28551,12,107,142,261,medium-high-risk
28557,0,0,0,0,low-risk
28559,12,142,167,321,medium-high-risk
2856,0,0,0,0,low-risk
28568,0,0,0,0,low-risk
28572,12,131,211,354,high-risk
28574,13,114,166,293,medium-high-risk
2858,12,120,156,288,medium-high-risk
28582,12,124,155,291,medium-high-risk
28596,0,0,0,0,low-risk
28601,0,0,0,0,low-risk
28603,15,99,148,262,medium-high-risk
2862,12,124,138,274,medium-high-risk
28620,12,84,49,145,medium-low-risk
28626,0,0,0,0,low-risk
28628,0,0,0,0,low-risk
28629,0,0,0,0,low-risk
28631,0,0,0,0,low-risk
28641,12,110,130,252,medium-high-risk
28652,0,0,0,0,low-risk
28656,12,143,182,337,high-risk
28658,0,0,0,0,low-risk
28661,0,0,0,0,low-risk
28669,12,85,118,215,medium-low-risk
28670,0,0,0,0,low-risk
28672,12,100,148,260,medium-high-risk
28673,13,85,149,247,medium-high-risk
28676,16,216,182,414,high-risk
28678,0,0,0,0,low-risk
28681,13,113,157,283,medium-high-risk
28682,0,0,0,0,low-risk
28684,12,133,172,317,medium-high-risk
28690,26,141,197,364,high-risk
28692,12,125,164,301,medium-high-risk
2870,0,0,0,0,low-risk
28716,0,0,0,0,low-risk
28717,12,118,106,236,medium-low-risk
28719,12,156,166,334,high-risk
28721,26,92,149,267,medium-high-risk
28725,0,0,0,0,low-risk
28732,0,0,0,0,low-risk
28735,11,127,149,287,medium-high-risk
28744,12,106,137,255,medium-high-risk
28747,0,0,0,0,low-risk
28750,27,142,184,353,high-risk
28753,12,139,205,356,high-risk
28756,0,0,0,0,low-risk
28758,0,0,0,0,low-risk
2876,8,98,243,349,high-risk
28767,12,181,240,433,high-risk
28776,45,119,234,398,high-risk
28787,12,124,166,302,medium-high-risk
28790,13,88,124,225,medium-low-risk
28791,0,0,0,0,low-risk
28803,14,120,187,321,medium-high-risk
2881,12,139,167,318,medium-high-risk
28813,0,0,0,0,low-risk
28823,19,87,130,236,medium-low-risk
2883,0,0,0,0,low-risk
28836,0,0,0,0,low-risk
28845,12,224,155,391,high-risk
28851,0,0,0,0,low-risk
28862,12,133,169,314,medium-high-risk
28871,0,0,0,0,low-risk
28873,12,156,180,348,high-risk
2888,12,107,132,251,medium-high-risk
28884,0,0,0,0,low-risk
28887,17,155,195,367,high-risk
2889,0,0,0,0,low-risk
28890,0,0,0,0,low-risk
28894,0,0,0,0,low-risk
28902,0,0,0,0,low-risk
28906,0,0,0,0,low-risk
28922,0,0,0,0,low-risk
28934,0,0,0,0,low-risk
2895,12,118,121,251,medium-high-risk
28953,0,0,0,0,low-risk
28961,0,0,0,0,low-risk
28972,12,254,186,452,high-risk
28976,20,136,168,324,medium-high-risk
28990,0,0,0,0,low-risk
28992,12,119,167,298,medium-high-risk
28993,13,79,143,235,medium-low-risk
29008,14,120,159,293,medium-high-risk
29030,21,107,148,276,medium-high-risk
29038,13,149,179,341,high-risk
2905,0,0,0,0,low-risk
29051,35,158,191,384,high-risk
29058,12,152,195,359,high-risk
29069,23,105,154,282,medium-high-risk
29087,12,121,129,262,medium-high-risk
2909,0,0,0,0,low-risk
2910,12,176,206,394,high-risk
29111,12,137,159,308,medium-high-risk
29113,12,120,151,283,medium-high-risk
29118,12,100,144,256,medium-high-risk
29136,16,131,174,321,medium-high-risk
29141,13,117,201,331,high-risk
29146,0,0,0,0,low-risk
29147,0,0,0,0,low-risk
29151,15,91,140,246,medium-high-risk
29152,0,0,0,0,low-risk
29156,0,0,0,0,low-risk
29162,0,0,0,0,low-risk
29163,0,0,0,0,low-risk
29164,28,164,245,437,high-risk
29168,13,184,235,432,high-risk
29172,13,101,138,252,medium-high-risk
29173,16,119,180,315,medium-high-risk
29178,0,0,0,0,low-risk
29187,0,0,0,0,low-risk
29198,24,141,175,340,high-risk
29202,24,153,199,376,high-risk
29203,0,0,0,0,low-risk
29210,17,66,113,196,medium-low-risk
29211,17,88,152,257,medium-high-risk
2922,0,0,0,0,low-risk
29223,0,0,0,0,low-risk
29240,15,215,208,438,high-risk
29242,12,86,126,224,medium-low-risk
29245,17,77,117,211,medium-low-risk
29257,0,0,0,0,low-risk
29259,22,144,240,406,high-risk
29264,37,111,156,304,medium-high-risk
29270,12,114,210,336,high-risk
29286,0,0,0,0,low-risk
29292,12,127,179,318,medium-high-risk
29302,12,174,208,394,high-risk
29303,21,128,173,322,medium-high-risk
29304,0,0,0,0,low-risk
29305,13,96,155,264,medium-high-risk
29308,12,111,158,281,medium-high-risk
29312,13,119,131,263,medium-high-risk
29314,21,95,163,279,medium-high-risk
29322,0,0,0,0,low-risk
29326,12,98,123,233,medium-low-risk
29330,0,0,0,0,low-risk
29340,12,143,186,341,high-risk
29341,0,0,0,0,low-risk
29366,12,114,149,275,medium-high-risk
29368,0,0,0,0,low-risk
29380,0,0,0,0,low-risk
29395,0,0,0,0,low-risk
29396,0,0,0,0,low-risk
29401,31,125,173,329,medium-high-risk
29403,32,229,331,592,high-risk
29405,0,0,0,0,low-risk
2941,0,0,0,0,low-risk
29410,12,161,197,370,high-risk
29414,12,146,224,382,high-risk
29415,0,0,0,0,low-risk
29418,31,149,189,369,high-risk
29422,24,127,189,340,high-risk
29428,0,0,0,0,low-risk
29439,34,142,177,353,high-risk
29443,12,143,178,333,high-risk
29448,12,165,231,408,high-risk
29449,12,125,144,281,medium-high-risk
29460,44,157,304,505,high-risk
29491,23,113,159,295,medium-high-risk
29529,14,97,123,234,medium-low-risk
29536,19,77,135,231,medium-low-risk
29545,0,0,0,0,low-risk
29546,12,107,118,237,medium-low-risk
29554,0,0,0,0,low-risk
29569,0,0,0,0,low-risk
29600,33,110,192,335,high-risk
29630,0,0,0,0,low-risk
29631,0,0,0,0,low-risk
29642,0,0,0,0,low-risk
29645,0,0,0,0,low-risk
29648,14,126,200,340,high-risk
29649,12,134,175,321,medium-high-risk
2966,0,0,0,0,low-risk
29677,13,68,95,176,medium-low-risk
29686,11,112,220,343,high-risk
29692,19,123,246,388,high-risk
29697,0,0,0,0,low-risk
29699,12,111,150,273,medium-high-risk
29702,12,123,192,327,medium-high-risk
29707,13,93,138,244,medium-low-risk
29708,12,225,158,395,high-risk
29720,12,83,136,231,medium-low-risk
29729,0,0,0,0,low-risk
29733,0,0,0,0,low-risk
29736,0,0,0,0,low-risk
29756,20,147,191,358,high-risk
29758,0,0,0,0,low-risk
29761,0,0,0,0,low-risk
29764,20,184,361,565,high-risk
29766,0,0,0,0,low-risk
29793,0,0,0,0,low-risk
29794,0,0,0,0,low-risk
29798,12,159,249,420,high-risk
29810,24,134,200,358,high-risk
29813,30,104,160,294,medium-high-risk
29825,13,131,157,301,medium-high-risk
2984,12,92,169,273,medium-high-risk
29842,0,0,0,0,low-risk
29845,0,0,0,0,low-risk
29848,12,140,208,360,high-risk
29856,0,0,0,0,low-risk
29859,25,133,167,325,medium-high-risk
29861,41,149,195,385,high-risk
29869,12,117,171,300,medium-high-risk
2987,29,107,176,312,medium-high-risk
29886,0,0,0,0,low-risk
29890,12,104,151,267,medium-high-risk
29899,0,0,0,0,low-risk
29904,0,0,0,0,low-risk
29906,0,0,0,0,low-risk
29908,0,0,0,0,low-risk
29918,12,195,222,429,high-risk
29922,12,160,233,405,high-risk
29926,12,114,152,278,medium-high-risk
29931,0,0,0,0,low-risk
29932,0,0,0,0,low-risk
29934,14,106,164,284,medium-high-risk
29936,12,138,116,266,medium-high-risk
29957,0,0,0,0,low-risk
29962,31,94,158,283,medium-high-risk
2997,20,111,157,288,medium-high-risk
29972,0,0,0,0,low-risk
29974,12,132,139,283,medium-high-risk
29979,26,90,144,260,medium-high-risk
29981,0,0,0,0,low-risk
29984,0,0,0,0,low-risk
29987,12,126,142,280,medium-high-risk
29993,12,66,101,179,medium-low-risk
29999,0,0,0,0,low-risk
30003,0,0,0,0,low-risk
30010,0,0,0,0,low-risk
30014,0,0,0,0,low-risk
30037,18,83,122,223,medium-low-risk
30040,16,113,190,319,medium-high-risk
30041,13,117,143,273,medium-high-risk
30044,0,0,0,0,low-risk
30050,20,194,219,433,high-risk
30053,23,159,253,435,high-risk
30071,0,0,0,0,low-risk
30072,12,121,136,269,medium-high-risk
30075,12,145,180,337,high-risk
30076,0,0,0,0,low-risk
30077,12,76,109,197,medium-low-risk
3008,0,0,0,0,low-risk
30082,21,140,180,341,high-risk
30084,16,143,253,412,high-risk
30087,0,0,0,0,low-risk
30091,0,0,0,0,low-risk
30095,0,0,0,0,low-risk
30096,12,143,175,330,high-risk
30099,0,0,0,0,low-risk
30101,12,165,198,375,high-risk
30122,12,121,154,287,medium-high-risk
30125,12,164,206,382,high-risk
30126,12,107,140,259,medium-high-risk
30127,0,0,0,0,low-risk
30129,13,127,233,373,high-risk
30131,0,0,0,0,low-risk
30132,0,0,0,0,low-risk
30137,0,0,0,0,low-risk
30140,0,0,0,0,low-risk
30143,12,100,135,247,medium-high-risk
30155,0,0,0,0,low-risk
30158,28,180,292,500,high-risk
30161,11,147,213,371,high-risk
30167,0,0,0,0,low-risk
3017,48,167,257,472,high-risk
30179,13,138,172,323,medium-high-risk
30184,0,0,0,0,low-risk
30197,12,154,218,384,high-risk
30198,16,103,153,272,medium-high-risk
30199,0,0,0,0,low-risk
30200,12,135,170,317,medium-high-risk
30204,36,165,214,415,high-risk
30208,12,132,152,296,medium-high-risk
30211,12,127,137,276,medium-high-risk
30214,0,0,0,0,low-risk
30216,12,80,133,225,medium-low-risk
30217,12,96,142,250,medium-high-risk
30254,12,114,228,354,high-risk
30264,0,0,0,0,low-risk
30266,0,0,0,0,low-risk
30269,14,112,180,306,medium-high-risk
30277,19,95,138,252,medium-high-risk
30279,12,108,132,252,medium-high-risk
30284,0,0,0,0,low-risk
30289,12,120,134,266,medium-high-risk
30292,23,111,165,299,medium-high-risk
30300,0,0,0,0,low-risk
30302,12,134,159,305,medium-high-risk
30305,12,120,158,290,medium-high-risk
30311,57,143,186,386,high-risk
30320,0,0,0,0,low-risk
30331,12,144,163,319,medium-high-risk
30337,18,125,176,319,medium-high-risk
30338,0,0,0,0,low-risk
30342,49,128,164,341,high-risk
30348,0,0,0,0,low-risk
30349,0,0,0,0,low-risk
30350,12,138,162,312,medium-high-risk
30352,11,133,170,314,medium-high-risk
30365,14,128,165,307,medium-high-risk
30368,0,0,0,0,low-risk
30379,12,131,146,289,medium-high-risk
30383,0,0,0,0,low-risk
30386,12,89,83,184,medium-low-risk
30393,0,0,0,0,low-risk
30397,12,89,115,216,medium-low-risk
30407,0,0,0,0,low-risk
30413,0,0,0,0,low-risk
30414,0,0,0,0,low-risk
30418,0,0,0,0,low-risk
30421,0,0,0,0,low-risk
30426,0,0,0,0,low-risk
30430,45,112,148,305,medium-high-risk
30434,0,0,0,0,low-risk
30437,0,0,0,0,low-risk
30445,0,0,0,0,low-risk
3045,20,145,193,358,high-risk
30462,0,0,0,0,low-risk
30464,0,0,0,0,low-risk
30468,0,0,0,0,low-risk
30473,12,209,258,479,high-risk
30475,24,110,238,372,high-risk
30479,12,168,210,390,high-risk
3048,12,166,212,390,high-risk
30483,0,0,0,0,low-risk
30489,12,188,263,463,high-risk
30496,0,0,0,0,low-risk
30497,19,133,184,336,high-risk
30501,0,0,0,0,low-risk
30508,41,156,218,415,high-risk
30514,0,0,0,0,low-risk
30520,0,0,0,0,low-risk
30536,41,214,220,475,high-risk
30553,12,191,235,438,high-risk
30605,64,182,256,502,high-risk
30607,0,0,0,0,low-risk
30617,16,89,140,245,medium-high-risk
30621,12,127,140,279,medium-high-risk
30622,0,0,0,0,low-risk
30625,12,80,109,201,medium-low-risk
3063,0,0,0,0,low-risk
30638,13,116,166,295,medium-high-risk
30643,12,141,186,339,high-risk
30655,12,170,198,380,high-risk
30657,0,0,0,0,low-risk
30659,14,91,145,250,medium-high-risk
30663,0,0,0,0,low-risk
30673,29,108,167,304,medium-high-risk
3070,16,136,164,316,medium-high-risk
30727,0,0,0,0,low-risk
30728,12,113,146,271,medium-high-risk
30744,0,0,0,0,low-risk
30746,0,0,0,0,low-risk
30750,0,0,0,0,low-risk
30758,32,136,191,359,high-risk
30760,12,115,153,280,medium-high-risk
30762,0,0,0,0,low-risk
30772,13,99,192,304,medium-high-risk
30778,0,0,0,0,low-risk
30792,0,0,0,0,low-risk
30813,0,0,0,0,low-risk
30820,0,0,0,0,low-risk
30823,0,0,0,0,low-risk
3083,13,82,136,231,medium-low-risk
30834,0,0,0,0,low-risk
30867,0,0,0,0,low-risk
30868,12,140,202,354,high-risk
30873,34,160,247,441,high-risk
30875,12,131,151,294,medium-high-risk
30877,0,0,0,0,low-risk
30885,16,97,131,244,medium-low-risk
30886,12,118,138,268,medium-high-risk
30891,19,104,147,270,medium-high-risk
30894,25,130,178,333,high-risk
30913,12,81,95,188,medium-low-risk
30923,12,123,214,349,high-risk
3093,12,136,155,303,medium-high-risk
30934,0,0,0,0,low-risk
3094,0,0,0,0,low-risk
30940,0,0,0,0,low-risk
30942,12,115,158,285,medium-high-risk
30949,38,131,179,348,high-risk
30962,12,121,223,356,high-risk
30968,0,0,0,0,low-risk
30975,0,0,0,0,low-risk
30976,12,138,160,310,medium-high-risk
30986,12,161,198,371,high-risk
30997,0,0,0,0,low-risk
30999,17,121,165,303,medium-high-risk
31002,16,152,229,397,high-risk
31006,0,0,0,0,low-risk
31018,20,121,163,304,medium-high-risk
3102,12,105,124,241,medium-low-risk
31030,12,130,158,300,medium-high-risk
31043,12,137,223,372,high-risk
31053,22,110,175,307,medium-high-risk
31056,39,132,175,346,high-risk
31063,12,123,161,296,medium-high-risk
3107,13,127,168,308,medium-high-risk
3109,12,107,122,241,medium-low-risk
31091,12,113,161,286,medium-high-risk
31100,0,0,0,0,low-risk
31105,12,75,102,189,medium-low-risk
31119,12,124,153,289,medium-high-risk
31129,0,0,0,0,low-risk
31134,26,106,183,315,medium-high-risk
31140,33,137,162,332,high-risk
31143,0,0,0,0,low-risk
31151,12,117,189,318,medium-high-risk
31155,59,163,253,475,high-risk
31178,0,0,0,0,low-risk
31184,25,129,202,356,high-risk
31185,0,0,0,0,low-risk
31201,0,0,0,0,low-risk
31207,0,0,0,0,low-risk
31209,0,0,0,0,low-risk
31222,0,0,0,0,low-risk
31229,0,0,0,0,low-risk
3123,0,0,0,0,low-risk
31231,0,0,0,0,low-risk
31232,0,0,0,0,low-risk
31234,0,0,0,0,low-risk
31243,13,109,141,263,medium-high-risk
31249,25,198,247,470,high-risk
31252,0,0,0,0,low-risk
31267,13,107,203,323,medium-high-risk
31277,0,0,0,0,low-risk
31285,15,74,116,205,medium-low-risk
31291,12,144,158,314,medium-high-risk
31295,0,0,0,0,low-risk
31296,0,0,0,0,low-risk
31299,58,140,175,373,high-risk
31302,12,95,120,227,medium-low-risk
31303,17,82,148,247,medium-high-risk
31304,0,0,0,0,low-risk
31311,0,0,0,0,low-risk
31329,21,167,202,390,high-risk
31354,29,123,182,334,high-risk
31357,0,0,0,0,low-risk
3137,0,0,0,0,low-risk
31370,17,109,147,273,medium-high-risk
31389,0,0,0,0,low-risk
31394,0,0,0,0,low-risk
31400,12,135,156,303,medium-high-risk
31410,0,0,0,0,low-risk
31418,25,118,153,296,medium-high-risk
31419,0,0,0,0,low-risk
3142,12,103,143,258,medium-high-risk
31421,0,0,0,0,low-risk
3143,14,175,340,529,high-risk
31438,12,82,150,244,medium-low-risk
3145,12,149,199,360,high-risk
31467,17,125,175,317,medium-high-risk
31468,12,140,186,338,high-risk
31469,12,108,132,252,medium-high-risk
31489,37,152,195,384,high-risk
31494,12,154,199,365,high-risk
31502,20,102,147,269,medium-high-risk
31509,20,119,193,332,high-risk
31514,22,134,275,431,high-risk
31522,17,116,159,292,medium-high-risk
31540,21,78,115,214,medium-low-risk
31543,21,135,182,338,high-risk
31544,13,119,209,341,high-risk
31550,12,193,160,365,high-risk
31551,34,129,208,371,high-risk
31562,17,78,134,229,medium-low-risk
31572,0,0,0,0,low-risk
3158,12,99,169,280,medium-high-risk
31583,0,0,0,0,low-risk
31596,19,173,210,402,high-risk
31600,0,0,0,0,low-risk
3162,0,0,0,0,low-risk
3163,0,0,0,0,low-risk
31639,0,0,0,0,low-risk
3164,0,0,0,0,low-risk
31647,0,0,0,0,low-risk
31650,12,146,283,441,high-risk
31655,12,100,130,242,medium-low-risk
31656,0,0,0,0,low-risk
31659,12,137,177,326,medium-high-risk
31660,0,0,0,0,low-risk
31664,12,103,122,237,medium-low-risk
31673,12,107,160,279,medium-high-risk
3168,0,0,0,0,low-risk
31681,19,89,142,250,medium-high-risk
31683,0,0,0,0,low-risk
31686,22,105,131,258,medium-high-risk
31693,0,0,0,0,low-risk
31696,0,0,0,0,low-risk
31703,12,141,211,364,high-risk
31707,32,148,196,376,high-risk
31726,30,128,141,299,medium-high-risk
31738,0,0,0,0,low-risk
31741,0,0,0,0,low-risk
31749,31,133,184,348,high-risk
31756,0,0,0,0,low-risk
31763,16,139,235,390,high-risk
31765,0,0,0,0,low-risk
31770,12,164,217,393,high-risk
31781,0,0,0,0,low-risk
31785,0,0,0,0,low-risk
31789,38,156,220,414,high-risk
31792,13,130,163,306,medium-high-risk
31797,12,119,130,261,medium-high-risk
31803,12,108,136,256,medium-high-risk
31806,0,0,0,0,low-risk
31810,0,0,0,0,low-risk
31814,20,76,132,228,medium-low-risk
31817,18,132,177,327,medium-high-risk
31827,12,133,205,350,high-risk
31832,33,164,213,410,high-risk
31834,12,144,180,336,high-risk
31840,36,169,233,438,high-risk
31842,12,119,147,278,medium-high-risk
31860,0,0,0,0,low-risk
31866,0,0,0,0,low-risk
31871,12,79,107,198,medium-low-risk
31891,12,136,176,324,medium-high-risk
31892,0,0,0,0,low-risk
31895,0,0,0,0,low-risk
31898,16,126,180,322,medium-high-risk
31907,29,102,159,290,medium-high-risk
31910,12,101,212,325,medium-high-risk
31911,0,0,0,0,low-risk
31938,12,98,143,253,medium-high-risk
31940,18,122,183,323,medium-high-risk
31948,27,123,178,328,medium-high-risk
31949,41,169,340,550,high-risk
31953,0,0,0,0,low-risk
31956,0,0,0,0,low-risk
31957,47,148,195,390,high-risk
31962,32,137,201,370,high-risk
31963,0,0,0,0,low-risk
31966,0,0,0,0,low-risk
31974,47,139,189,375,high-risk
31976,0,0,0,0,low-risk
31985,0,0,0,0,low-risk
32003,0,0,0,0,low-risk
32016,17,84,171,272,medium-high-risk
32021,0,0,0,0,low-risk
32029,12,130,172,314,medium-high-risk
32035,30,153,190,373,high-risk
32063,0,0,0,0,low-risk
32064,0,0,0,0,low-risk
32065,29,155,194,378,high-risk
32074,0,0,0,0,low-risk
32075,13,144,281,438,high-risk
32083,0,0,0,0,low-risk
32090,0,0,0,0,low-risk
32091,0,0,0,0,low-risk
32093,0,0,0,0,low-risk
32108,24,82,144,250,medium-high-risk
32109,13,109,142,264,medium-high-risk
3211,0,0,0,0,low-risk
32112,38,120,194,352,high-risk
32114,0,0,0,0,low-risk
32122,0,0,0,0,low-risk
32131,35,127,210,372,high-risk
32146,15,94,138,247,medium-high-risk
32150,12,139,164,315,medium-high-risk
32156,12,127,172,311,medium-high-risk
32166,12,166,241,419,high-risk
32167,22,130,167,319,medium-high-risk
32168,28,130,188,346,high-risk
3217,34,99,157,290,medium-high-risk
32174,0,0,0,0,low-risk
32185,12,131,127,270,medium-high-risk
32186,12,204,197,413,high-risk
32197,58,148,186,392,high-risk
32205,0,0,0,0,low-risk
32209,23,85,128,236,medium-low-risk
32217,0,0,0,0,low-risk
32221,13,128,167,308,medium-high-risk
32227,0,0,0,0,low-risk
32228,0,0,0,0,low-risk
32231,0,0,0,0,low-risk
32242,23,139,242,404,high-risk
32254,0,0,0,0,low-risk
3226,12,131,165,308,medium-high-risk
32260,28,103,160,291,medium-high-risk
3227,0,0,0,0,low-risk
32283,12,172,197,381,high-risk
32308,12,133,140,285,medium-high-risk
32309,0,0,0,0,low-risk
32313,0,0,0,0,low-risk
32326,23,161,220,404,high-risk
32333,50,139,420,609,high-risk
32336,0,0,0,0,low-risk
32345,17,129,183,329,medium-high-risk
32361,0,0,0,0,low-risk
32364,0,0,0,0,low-risk
32366,0,0,0,0,low-risk
32368,0,0,0,0,low-risk
3237,12,143,201,356,high-risk
32382,18,87,119,224,medium-low-risk
32387,14,124,193,331,high-risk
3239,0,0,0,0,low-risk
32391,12,119,141,272,medium-high-risk
32392,15,94,154,263,medium-high-risk
32400,0,0,0,0,low-risk
32402,25,98,169,292,medium-high-risk
32403,12,117,127,256,medium-high-risk
3241,12,143,179,334,high-risk
32413,13,111,156,280,medium-high-risk
32418,12,178,224,414,high-risk
32432,0,0,0,0,low-risk
32437,13,112,234,359,high-risk
32452,12,115,142,269,medium-high-risk
32454,0,0,0,0,low-risk
32491,17,126,209,352,high-risk
32498,12,100,129,241,medium-low-risk
32515,0,0,0,0,low-risk
32516,31,112,151,294,medium-high-risk
3252,14,134,212,360,high-risk
32520,0,0,0,0,low-risk
32521,12,172,228,412,high-risk
32534,18,133,246,397,high-risk
32541,12,129,157,298,medium-high-risk
32542,0,0,0,0,low-risk
32565,0,0,0,0,low-risk
32569,0,0,0,0,low-risk
32573,12,108,120,240,medium-low-risk
32585,0,0,0,0,low-risk
32587,12,113,122,247,medium-high-risk
32588,0,0,0,0,low-risk
32603,0,0,0,0,low-risk
32608,0,0,0,0,low-risk
3261,0,0,0,0,low-risk
32613,0,0,0,0,low-risk
32614,22,104,154,280,medium-high-risk
32616,0,0,0,0,low-risk
32619,12,139,183,334,high-risk
32635,48,164,327,539,high-risk
32641,15,105,151,271,medium-high-risk
32646,0,0,0,0,low-risk
32649,12,123,145,280,medium-high-risk
32653,0,0,0,0,low-risk
32661,29,158,213,400,high-risk
32667,0,0,0,0,low-risk
32675,0,0,0,0,low-risk
3269,18,93,130,241,medium-low-risk
32692,12,140,175,327,medium-high-risk
32706,12,124,170,306,medium-high-risk
32723,0,0,0,0,low-risk
32732,32,100,169,301,medium-high-risk
32737,34,171,235,440,high-risk
32754,12,155,173,340,high-risk
32757,12,125,80,217,medium-low-risk
32758,0,0,0,0,low-risk
32759,12,114,124,250,medium-high-risk
32760,23,113,140,276,medium-high-risk
32762,0,0,0,0,low-risk
32767,40,135,154,329,medium-high-risk
32768,13,126,215,354,high-risk
32790,17,81,225,323,medium-high-risk
32794,0,0,0,0,low-risk
32798,12,114,142,268,medium-high-risk
32807,12,111,122,245,medium-high-risk
32808,13,99,137,249,medium-high-risk
32821,0,0,0,0,low-risk
32827,32,170,191,393,high-risk
32832,12,126,154,292,medium-high-risk
32838,12,100,124,236,medium-low-risk
32849,0,0,0,0,low-risk
3285,13,132,176,321,medium-high-risk
32854,11,139,161,311,medium-high-risk
32858,27,149,264,440,high-risk
32859,17,125,208,350,high-risk
3286,0,0,0,0,low-risk
32861,0,0,0,0,low-risk
32865,17,135,241,393,high-risk
32866,0,0,0,0,low-risk
3287,12,158,199,369,high-risk
32870,0,0,0,0,low-risk
32889,12,137,166,315,medium-high-risk
32891,12,133,160,305,medium-high-risk
32895,0,0,0,0,low-risk
32898,12,63,98,173,medium-low-risk
32901,0,0,0,0,low-risk
32909,0,0,0,0,low-risk
3291,12,140,163,315,medium-high-risk
32923,0,0,0,0,low-risk
32947,0,0,0,0,low-risk
32955,12,114,168,294,medium-high-risk
32958,0,0,0,0,low-risk
3296,12,159,213,384,high-risk
32978,15,128,167,310,medium-high-risk
32988,16,104,165,285,medium-high-risk
32991,12,132,151,295,medium-high-risk
32997,12,182,207,401,high-risk
32998,12,153,185,350,high-risk
33012,0,0,0,0,low-risk
33015,12,119,184,315,medium-high-risk
33018,12,80,119,211,medium-low-risk
33028,0,0,0,0,low-risk
33038,0,0,0,0,low-risk
33047,12,121,158,291,medium-high-risk
33051,12,102,125,239,medium-low-risk
33055,0,0,0,0,low-risk
33065,19,106,181,306,medium-high-risk
33082,23,119,162,304,medium-high-risk
33086,12,246,167,425,high-risk
33092,13,97,119,229,medium-low-risk
33112,22,120,169,311,medium-high-risk
33117,0,0,0,0,low-risk
33121,38,161,209,408,high-risk
33124,24,75,110,209,medium-low-risk
33128,0,0,0,0,low-risk
33130,0,0,0,0,low-risk
33131,26,142,188,356,high-risk
33132,35,118,160,313,medium-high-risk
33133,0,0,0,0,low-risk
33137,0,0,0,0,low-risk
33151,0,0,0,0,low-risk
33155,0,0,0,0,low-risk
33156,12,149,201,362,high-risk
33162,0,0,0,0,low-risk
3317,22,79,107,208,medium-low-risk
33172,0,0,0,0,low-risk
33175,0,0,0,0,low-risk
33185,0,0,0,0,low-risk
3319,0,0,0,0,low-risk
33192,12,119,150,281,medium-high-risk
33203,0,0,0,0,low-risk
33217,0,0,0,0,low-risk
33224,0,0,0,0,low-risk
33245,0,0,0,0,low-risk
33246,0,0,0,0,low-risk
33252,0,0,0,0,low-risk
33257,34,122,192,348,high-risk
33266,12,139,214,365,high-risk
33270,13,145,247,405,high-risk
33273,0,0,0,0,low-risk
33284,12,129,192,333,high-risk
3329,14,135,193,342,high-risk
33298,12,141,172,325,medium-high-risk
33312,0,0,0,0,low-risk
33313,12,107,154,273,medium-high-risk
33317,0,0,0,0,low-risk
33321,12,130,171,313,medium-high-risk
33334,12,106,130,248,medium-high-risk
33335,20,95,124,239,medium-low-risk
33338,0,0,0,0,low-risk
33340,0,0,0,0,low-risk
3335,0,0,0,0,low-risk
33362,12,95,129,236,medium-low-risk
33369,0,0,0,0,low-risk
33380,0,0,0,0,low-risk
33387,0,0,0,0,low-risk
33401,0,0,0,0,low-risk
33408,0,0,0,0,low-risk
33411,12,135,168,315,medium-high-risk
33443,40,96,187,323,medium-high-risk
33464,0,0,0,0,low-risk
3347,0,0,0,0,low-risk
33477,0,0,0,0,low-risk
33478,0,0,0,0,low-risk
33483,15,146,166,327,medium-high-risk
33486,32,171,198,401,high-risk
33491,12,139,210,361,high-risk
33502,0,0,0,0,low-risk
33504,0,0,0,0,low-risk
33506,14,87,146,247,medium-high-risk
33512,15,95,147,257,medium-high-risk
33516,12,146,165,323,medium-high-risk
33524,12,68,70,150,medium-low-risk
33536,12,112,124,248,medium-high-risk
33549,18,133,170,321,medium-high-risk
33557,51,154,216,421,high-risk
33562,12,174,201,387,high-risk
33571,43,152,175,370,high-risk
33576,0,0,0,0,low-risk
33580,0,0,0,0,low-risk
33582,0,0,0,0,low-risk
33583,13,90,158,261,medium-high-risk
33585,12,115,214,341,high-risk
33588,12,97,125,234,medium-low-risk
33589,0,0,0,0,low-risk
33591,12,113,157,282,medium-high-risk
33594,12,117,125,254,medium-high-risk
33608,12,140,162,314,medium-high-risk
33611,20,115,166,301,medium-high-risk
33612,12,99,130,241,medium-low-risk
33617,0,0,0,0,low-risk
3362,12,152,193,357,high-risk
33620,12,153,173,338,high-risk
33629,0,0,0,0,low-risk
33631,19,86,134,239,medium-low-risk
33632,0,0,0,0,low-risk
33633,12,203,132,347,high-risk
33641,12,98,120,230,medium-low-risk
33650,12,99,168,279,medium-high-risk
33661,25,173,221,419,high-risk
33683,18,77,139,234,medium-low-risk
33693,12,89,133,234,medium-low-risk
33698,0,0,0,0,low-risk
33710,27,94,148,269,medium-high-risk
33712,0,0,0,0,low-risk
33714,15,147,217,379,high-risk
33725,13,123,222,358,high-risk
33732,12,159,238,409,high-risk
33739,12,139,168,319,medium-high-risk
33744,18,76,121,215,medium-low-risk
3375,0,0,0,0,low-risk
33768,12,85,89,186,medium-low-risk
3378,12,80,99,191,medium-low-risk
33783,12,103,147,262,medium-high-risk
33792,0,0,0,0,low-risk
33799,19,151,247,417,high-risk
33803,12,168,189,369,high-risk
33809,0,0,0,0,low-risk
3381,20,98,142,260,medium-high-risk
33810,0,0,0,0,low-risk
33814,12,92,143,247,medium-high-risk
33833,12,133,160,305,medium-high-risk
33861,0,0,0,0,low-risk
33875,12,100,128,240,medium-low-risk
33878,12,110,163,285,medium-high-risk
33882,31,139,180,350,high-risk
33883,0,0,0,0,low-risk
33891,0,0,0,0,low-risk
33899,28,130,213,371,high-risk
33900,0,0,0,0,low-risk
33904,21,145,208,374,high-risk
33916,20,190,238,448,high-risk
33917,25,133,179,337,high-risk
33922,45,135,180,360,high-risk
33923,35,149,178,362,high-risk
33926,12,132,143,287,medium-high-risk
33927,0,0,0,0,low-risk
33942,12,209,240,461,high-risk
33949,0,0,0,0,low-risk
3395,32,116,174,322,medium-high-risk
33958,17,126,176,319,medium-high-risk
33972,0,0,0,0,low-risk
33975,12,120,144,276,medium-high-risk
33980,0,0,0,0,low-risk
33982,0,0,0,0,low-risk
33991,12,100,143,255,medium-high-risk
33997,32,167,202,401,high-risk
34002,0,0,0,0,low-risk
34016,0,0,0,0,low-risk
34018,0,0,0,0,low-risk
3402,12,78,106,196,medium-low-risk
34022,0,0,0,0,low-risk
34036,0,0,0,0,low-risk
34041,12,123,141,276,medium-high-risk
34046,12,163,188,363,high-risk
34054,12,85,114,211,medium-low-risk
34055,13,137,181,331,high-risk
34063,0,0,0,0,low-risk
34072,26,126,205,357,high-risk
34075,0,0,0,0,low-risk
34082,0,0,0,0,low-risk
34083,0,0,0,0,low-risk
34087,0,0,0,0,low-risk
34092,16,99,168,283,medium-high-risk
34096,12,120,132,264,medium-high-risk
34097,44,159,204,407,high-risk
34107,12,83,64,159,medium-low-risk
34114,20,71,120,211,medium-low-risk
34123,17,145,167,329,medium-high-risk
34128,12,113,133,258,medium-high-risk
34134,12,100,234,346,high-risk
34136,31,192,219,442,high-risk
34139,0,0,0,0,low-risk
34140,0,0,0,0,low-risk
34142,12,143,184,339,high-risk
34144,12,154,183,349,high-risk
34155,0,0,0,0,low-risk
34160,12,84,113,209,medium-low-risk
34168,24,114,166,304,medium-high-risk
3417,12,132,158,302,medium-high-risk
34171,0,0,0,0,low-risk
34180,12,125,191,328,medium-high-risk
34182,0,0,0,0,low-risk
34184,0,0,0,0,low-risk
34189,18,107,168,293,medium-high-risk
34190,0,0,0,0,low-risk
34196,33,126,165,324,medium-high-risk
34204,0,0,0,0,low-risk
34217,0,0,0,0,low-risk
34218,15,73,125,213,medium-low-risk
34220,0,0,0,0,low-risk
34232,12,123,209,344,high-risk
34239,12,114,199,325,medium-high-risk
34243,0,0,0,0,low-risk
34263,12,140,166,318,medium-high-risk
34268,0,0,0,0,low-risk
34275,12,92,147,251,medium-high-risk
34283,0,0,0,0,low-risk
34291,0,0,0,0,low-risk
34304,27,142,176,345,high-risk
3431,13,138,176,327,medium-high-risk
34317,0,0,0,0,low-risk
34318,0,0,0,0,low-risk
34332,12,159,202,373,high-risk
34365,0,0,0,0,low-risk
34377,0,0,0,0,low-risk
34387,0,0,0,0,low-risk
34394,14,133,226,373,high-risk
34405,0,0,0,0,low-risk
34409,12,117,160,289,medium-high-risk
34414,12,218,196,426,high-risk
34431,35,121,189,345,high-risk
34450,12,129,140,281,medium-high-risk
34456,0,0,0,0,low-risk
34461,0,0,0,0,low-risk
34462,12,139,201,352,high-risk
34472,0,0,0,0,low-risk
34501,19,73,117,209,medium-low-risk
34505,0,0,0,0,low-risk
34520,0,0,0,0,low-risk
34532,25,166,239,430,high-risk
34533,12,153,203,368,high-risk
34539,12,155,191,358,high-risk
34542,30,92,177,299,medium-high-risk
34546,12,99,141,252,medium-high-risk
34554,31,160,186,377,high-risk
3456,12,202,208,422,high-risk
34568,28,208,275,511,high-risk
34570,0,0,0,0,low-risk
34573,33,165,214,412,high-risk
3458,12,180,216,408,high-risk
34587,0,0,0,0,low-risk
34596,0,0,0,0,low-risk
34610,13,120,255,388,high-risk
3462,0,0,0,0,low-risk
3465,12,159,178,349,high-risk
34655,0,0,0,0,low-risk
34659,12,156,216,384,high-risk
34665,12,124,218,354,high-risk
34672,26,125,163,314,medium-high-risk
34678,12,143,254,409,high-risk
34686,0,0,0,0,low-risk
34689,15,198,320,533,high-risk
34698,12,141,243,396,high-risk
34709,0,0,0,0,low-risk
34715,0,0,0,0,low-risk
3472,12,123,184,319,medium-high-risk
34721,20,157,265,442,high-risk
34722,12,98,72,182,medium-low-risk
34732,0,0,0,0,low-risk
34734,12,103,139,254,medium-high-risk
34736,12,94,145,251,medium-high-risk
34748,31,145,197,373,high-risk
34753,12,108,134,254,medium-high-risk
34772,13,138,291,442,high-risk
34785,24,325,242,591,high-risk
34794,12,108,184,304,medium-high-risk
34797,17,114,189,320,medium-high-risk
34808,12,118,152,282,medium-high-risk
3483,0,0,0,0,low-risk
34851,12,85,122,219,medium-low-risk
34861,20,112,162,294,medium-high-risk
34874,18,90,138,246,medium-high-risk
34878,0,0,0,0,low-risk
34880,12,148,177,337,high-risk
34887,0,0,0,0,low-risk
34888,35,129,178,342,high-risk
34897,28,128,193,349,high-risk
34899,12,82,139,233,medium-low-risk
3491,0,0,0,0,low-risk
34915,22,88,147,257,medium-high-risk
34922,0,0,0,0,low-risk
34923,12,166,209,387,high-risk
3495,0,0,0,0,low-risk
34952,0,0,0,0,low-risk
34955,0,0,0,0,low-risk
34962,24,100,136,260,medium-high-risk
34966,0,0,0,0,low-risk
34967,0,0,0,0,low-risk
34969,12,120,161,293,medium-high-risk
34974,12,139,129,280,medium-high-risk
3498,35,173,199,407,high-risk
34990,0,0,0,0,low-risk
35011,12,122,183,317,medium-high-risk
35013,27,96,149,272,medium-high-risk
35020,27,153,177,357,high-risk
35028,23,94,141,258,medium-high-risk
35034,12,136,176,324,medium-high-risk
35038,17,111,152,280,medium-high-risk
35044,38,127,161,326,medium-high-risk
35047,0,0,0,0,low-risk
35057,0,0,0,0,low-risk
35064,12,87,127,226,medium-low-risk
35072,12,81,106,199,medium-low-risk
35080,0,0,0,0,low-risk
35083,29,102,209,340,high-risk
35088,0,0,0,0,low-risk
35104,12,237,199,448,high-risk
35110,12,124,145,281,medium-high-risk
35112,12,128,158,298,medium-high-risk
35113,36,140,188,364,high-risk
3512,12,111,134,257,medium-high-risk
35121,15,142,225,382,high-risk
35125,0,0,0,0,low-risk
35130,12,93,120,225,medium-low-risk
35146,0,0,0,0,low-risk
35148,12,273,235,520,high-risk
3515,0,0,0,0,low-risk
35158,12,105,103,220,medium-low-risk
35159,40,137,209,386,high-risk
35165,12,86,143,241,medium-low-risk
35166,33,122,213,368,high-risk
35168,0,0,0,0,low-risk
35177,19,125,163,307,medium-high-risk
35180,17,108,154,279,medium-high-risk
35184,0,0,0,0,low-risk
35189,39,167,217,423,high-risk
35190,11,128,176,315,medium-high-risk
35200,12,141,154,307,medium-high-risk
35202,0,0,0,0,low-risk
3521,30,91,167,288,medium-high-risk
35212,17,119,142,278,medium-high-risk
35229,0,0,0,0,low-risk
35230,0,0,0,0,low-risk
35235,0,0,0,0,low-risk
35238,26,136,216,378,high-risk
35239,12,115,134,261,medium-high-risk
35242,12,163,185,360,high-risk
35244,12,194,238,444,high-risk
35250,0,0,0,0,low-risk
35252,21,110,178,309,medium-high-risk
35256,0,0,0,0,low-risk
35257,0,0,0,0,low-risk
35259,12,108,190,310,medium-high-risk
35272,12,119,212,343,high-risk
35298,22,150,193,365,high-risk
35302,12,82,125,219,medium-low-risk
35303,12,137,181,330,high-risk
35307,27,134,187,348,high-risk
35308,0,0,0,0,low-risk
35312,0,0,0,0,low-risk
35317,18,156,199,373,high-risk
35320,0,0,0,0,low-risk
35324,0,0,0,0,low-risk
35327,33,125,207,365,high-risk
35332,0,0,0,0,low-risk
35337,0,0,0,0,low-risk
35343,0,0,0,0,low-risk
35351,0,0,0,0,low-risk
35362,12,82,126,220,medium-low-risk
35375,31,140,169,340,high-risk
35386,12,164,205,381,high-risk
35393,29,133,191,353,high-risk
35403,12,178,301,491,high-risk
35419,35,140,181,356,high-risk
35427,12,109,160,281,medium-high-risk
35429,12,133,155,300,medium-high-risk
35433,12,108,181,301,medium-high-risk
35434,0,0,0,0,low-risk
35451,0,0,0,0,low-risk
35457,12,154,209,375,high-risk
35463,22,75,107,204,medium-low-risk
35467,0,0,0,0,low-risk
35468,33,110,187,330,high-risk
35473,0,0,0,0,low-risk
3548,0,0,0,0,low-risk
35487,12,136,154,302,medium-high-risk
35504,24,313,206,543,high-risk
35516,36,106,172,314,medium-high-risk
35519,0,0,0,0,low-risk
35527,11,103,197,311,medium-high-risk
35535,12,132,169,313,medium-high-risk
35543,0,0,0,0,low-risk
35551,12,139,177,328,medium-high-risk
35552,12,108,129,249,medium-high-risk
35556,0,0,0,0,low-risk
3556,0,0,0,0,low-risk
35565,42,147,194,383,high-risk
35572,0,0,0,0,low-risk
3559,21,127,189,337,high-risk
35590,0,0,0,0,low-risk
35599,12,75,102,189,medium-low-risk
3560,0,0,0,0,low-risk
35600,0,0,0,0,low-risk
35614,12,91,124,227,medium-low-risk
35616,0,0,0,0,low-risk
35625,47,212,219,478,high-risk
35630,23,70,192,285,medium-high-risk
35632,12,91,133,236,medium-low-risk
35646,29,124,217,370,high-risk
35659,17,187,232,436,high-risk
35664,12,135,148,295,medium-high-risk
35669,0,0,0,0,low-risk
35675,0,0,0,0,low-risk
35681,0,0,0,0,low-risk
35683,0,0,0,0,low-risk
35691,12,98,156,266,medium-high-risk
35693,12,106,134,252,medium-high-risk
35705,0,0,0,0,low-risk
35708,0,0,0,0,low-risk
35709,12,190,275,477,high-risk
35715,0,0,0,0,low-risk
35726,0,0,0,0,low-risk
35743,0,0,0,0,low-risk
35746,17,121,154,292,medium-high-risk
35747,11,159,185,355,high-risk
3575,12,155,205,372,high-risk
35762,12,156,210,378,high-risk
3577,14,135,201,350,high-risk
35774,12,135,152,299,medium-high-risk
35781,37,154,204,395,high-risk
3580,26,89,137,252,medium-high-risk
35802,40,136,381,557,high-risk
35806,0,0,0,0,low-risk
35812,0,0,0,0,low-risk
35813,12,61,106,179,medium-low-risk
3582,16,101,149,266,medium-high-risk
35820,11,143,159,313,medium-high-risk
35823,31,105,165,301,medium-high-risk
35828,0,0,0,0,low-risk
35837,18,80,115,213,medium-low-risk
35840,12,163,237,412,high-risk
35843,0,0,0,0,low-risk
35851,18,117,158,293,medium-high-risk
35855,11,138,184,333,high-risk
35875,13,126,168,307,medium-high-risk
35880,0,0,0,0,low-risk
35883,12,81,139,232,medium-low-risk
35900,12,119,158,289,medium-high-risk
35915,12,159,199,370,high-risk
35916,0,0,0,0,low-risk
3592,0,0,0,0,low-risk
35930,0,0,0,0,low-risk
35931,0,0,0,0,low-risk
35940,12,134,185,331,high-risk
35944,12,74,127,213,medium-low-risk
35953,40,132,194,366,high-risk
35960,16,96,123,235,medium-low-risk
35961,12,134,210,356,high-risk
35965,0,0,0,0,low-risk
35966,0,0,0,0,low-risk
35972,0,0,0,0,low-risk
35976,12,128,198,338,high-risk
3598,0,0,0,0,low-risk
35982,21,132,189,342,high-risk
35983,0,0,0,0,low-risk
3599,12,127,145,284,medium-high-risk
36007,0,0,0,0,low-risk
36015,12,129,213,354,high-risk
3602,13,120,195,328,medium-high-risk
3603,0,0,0,0,low-risk
36034,0,0,0,0,low-risk
36035,12,131,164,307,medium-high-risk
36041,0,0,0,0,low-risk
36044,0,0,0,0,low-risk
36067,12,120,108,240,medium-low-risk
36073,12,168,202,382,high-risk
36079,0,0,0,0,low-risk
36083,12,138,217,367,high-risk
36109,0,0,0,0,low-risk
3611,0,0,0,0,low-risk
36110,0,0,0,0,low-risk
36117,13,188,252,453,high-risk
36119,0,0,0,0,low-risk
36130,20,117,178,315,medium-high-risk
36138,0,0,0,0,low-risk
36143,0,0,0,0,low-risk
36145,12,86,136,234,medium-low-risk
3615,17,147,191,355,high-risk
36150,68,193,242,503,high-risk
36160,11,94,96,201,medium-low-risk
36164,0,0,0,0,low-risk
36179,12,277,313,602,high-risk
36184,0,0,0,0,low-risk
36185,0,0,0,0,low-risk
36188,0,0,0,0,low-risk
36194,0,0,0,0,low-risk
36201,0,0,0,0,low-risk
36202,24,105,155,284,medium-high-risk
36205,16,120,158,294,medium-high-risk
36227,14,98,122,234,medium-low-risk
3624,0,0,0,0,low-risk
36265,0,0,0,0,low-risk
36269,0,0,0,0,low-risk
36270,12,127,152,291,medium-high-risk
36276,12,134,112,258,medium-high-risk
36280,30,135,188,353,high-risk
36283,0,0,0,0,low-risk
36284,0,0,0,0,low-risk
36285,12,141,161,314,medium-high-risk
36291,16,98,140,254,medium-high-risk
36292,0,0,0,0,low-risk
36296,0,0,0,0,low-risk
36316,16,163,208,387,high-risk
36320,0,0,0,0,low-risk
36322,0,0,0,0,low-risk
36335,24,123,153,300,medium-high-risk
36338,0,0,0,0,low-risk
3634,23,127,173,323,medium-high-risk
36346,0,0,0,0,low-risk
36347,0,0,0,0,low-risk
36350,18,115,165,298,medium-high-risk
36352,30,148,249,427,high-risk
36353,16,140,165,321,medium-high-risk
36360,0,0,0,0,low-risk
36379,12,93,124,229,medium-low-risk
3638,25,130,159,314,medium-high-risk
36380,27,112,183,322,medium-high-risk
36391,24,124,182,330,high-risk
36393,12,141,160,313,medium-high-risk
36399,0,0,0,0,low-risk
36402,12,152,95,259,medium-high-risk
36409,27,158,228,413,high-risk
36416,12,130,137,279,medium-high-risk
36417,12,120,153,285,medium-high-risk
3642,31,105,174,310,medium-high-risk
36424,0,0,0,0,low-risk
36426,41,214,326,581,high-risk
36430,0,0,0,0,low-risk
36436,16,79,131,226,medium-low-risk
36437,0,0,0,0,low-risk
36440,12,156,184,352,high-risk
36450,0,0,0,0,low-risk
36460,12,144,213,369,high-risk
3648,0,0,0,0,low-risk
3650,38,91,164,293,medium-high-risk
36501,24,124,163,311,medium-high-risk
36502,15,110,154,279,medium-high-risk
36510,15,114,160,289,medium-high-risk
36513,0,0,0,0,low-risk
36523,26,153,207,386,high-risk
36540,23,88,172,283,medium-high-risk
36541,0,0,0,0,low-risk
36543,0,0,0,0,low-risk
36544,12,86,126,224,medium-low-risk
36550,0,0,0,0,low-risk
36555,0,0,0,0,low-risk
36556,12,123,161,296,medium-high-risk
36566,0,0,0,0,low-risk
3657,0,0,0,0,low-risk
36570,25,136,182,343,high-risk
36573,0,0,0,0,low-risk
36580,12,114,186,312,medium-high-risk
36585,0,0,0,0,low-risk
36587,0,0,0,0,low-risk
36596,0,0,0,0,low-risk
36611,0,0,0,0,low-risk
36614,0,0,0,0,low-risk
36638,0,0,0,0,low-risk
36642,14,146,187,347,high-risk
36647,12,127,141,280,medium-high-risk
36648,18,90,163,271,medium-high-risk
36655,0,0,0,0,low-risk
36659,26,130,165,321,medium-high-risk
36660,16,120,171,307,medium-high-risk
36669,12,59,106,177,medium-low-risk
36688,0,0,0,0,low-risk
36694,0,0,0,0,low-risk
36713,0,0,0,0,low-risk
36724,0,0,0,0,low-risk
36725,12,141,234,387,high-risk
36732,22,91,168,281,medium-high-risk
36733,12,78,119,209,medium-low-risk
36740,0,0,0,0,low-risk
36741,0,0,0,0,low-risk
3675,14,120,177,311,medium-high-risk
36754,12,163,213,388,high-risk
36757,36,145,202,383,high-risk
36760,11,87,186,284,medium-high-risk
36773,26,94,145,265,medium-high-risk
36776,0,0,0,0,low-risk
36779,0,0,0,0,low-risk
36798,13,86,133,232,medium-low-risk
3680,0,0,0,0,low-risk
36802,19,99,173,291,medium-high-risk
36815,12,88,136,236,medium-low-risk
36833,21,108,138,267,medium-high-risk
36838,14,97,150,261,medium-high-risk
36840,18,67,109,194,medium-low-risk
36855,20,136,246,402,high-risk
36856,11,108,151,270,medium-high-risk
36877,33,155,177,365,high-risk
36888,14,159,225,398,high-risk
36893,12,87,112,211,medium-low-risk
36905,0,0,0,0,low-risk
36919,33,183,285,501,high-risk
36923,43,149,233,425,high-risk
36929,13,81,130,224,medium-low-risk
36933,0,0,0,0,low-risk
3694,12,97,137,246,medium-high-risk
36964,12,130,155,297,medium-high-risk
36969,0,0,0,0,low-risk
36997,0,0,0,0,low-risk
37009,12,139,167,318,medium-high-risk
37014,19,75,116,210,medium-low-risk
37025,0,0,0,0,low-risk
3704,12,117,104,233,medium-low-risk
37074,18,118,160,296,medium-high-risk
37080,13,139,230,382,high-risk
37083,17,64,130,211,medium-low-risk
37094,22,177,236,435,high-risk
37098,0,0,0,0,low-risk
37100,12,75,99,186,medium-low-risk
37105,0,0,0,0,low-risk
37108,0,0,0,0,low-risk
37109,0,0,0,0,low-risk
37117,0,0,0,0,low-risk
3712,12,120,143,275,medium-high-risk
37139,39,181,242,462,high-risk
37145,12,145,153,310,medium-high-risk
37152,12,128,157,297,medium-high-risk
37155,0,0,0,0,low-risk
37177,27,113,155,295,medium-high-risk
37186,0,0,0,0,low-risk
37187,0,0,0,0,low-risk
37200,27,90,242,359,high-risk
37202,0,0,0,0,low-risk
37205,44,150,243,437,high-risk
37223,12,136,232,380,high-risk
37225,22,151,206,379,high-risk
37231,0,0,0,0,low-risk
37235,14,173,217,404,high-risk
37245,12,116,144,272,medium-high-risk
37248,0,0,0,0,low-risk
37249,44,131,199,374,high-risk
3725,0,0,0,0,low-risk
37250,12,155,188,355,high-risk
37259,0,0,0,0,low-risk
37260,12,165,249,426,high-risk
37261,0,0,0,0,low-risk
37263,12,106,114,232,medium-low-risk
37272,34,143,186,363,high-risk
37275,0,0,0,0,low-risk
37281,12,136,150,298,medium-high-risk
37285,20,82,142,244,medium-low-risk
3729,0,0,0,0,low-risk
37305,20,125,165,310,medium-high-risk
37310,0,0,0,0,low-risk
37319,0,0,0,0,low-risk
37340,17,87,138,242,medium-low-risk
37345,0,0,0,0,low-risk
37368,0,0,0,0,low-risk
37379,0,0,0,0,low-risk
37383,32,166,210,408,high-risk
37389,0,0,0,0,low-risk
37418,0,0,0,0,low-risk
37422,0,0,0,0,low-risk
37425,25,180,211,416,high-risk
37432,15,92,172,279,medium-high-risk
37438,0,0,0,0,low-risk
37458,0,0,0,0,low-risk
37468,0,0,0,0,low-risk
3747,0,0,0,0,low-risk
37490,12,130,166,308,medium-high-risk
37493,0,0,0,0,low-risk
37495,12,147,138,297,medium-high-risk
37498,0,0,0,0,low-risk
37500,12,113,157,282,medium-high-risk
37501,0,0,0,0,low-risk
37507,28,143,265,436,high-risk
37519,42,148,180,370,high-risk
37524,13,81,120,214,medium-low-risk
37526,12,90,121,223,medium-low-risk
37530,14,87,126,227,medium-low-risk
37534,0,0,0,0,low-risk
37535,0,0,0,0,low-risk
37538,13,100,141,254,medium-high-risk
37539,12,92,102,206,medium-low-risk
37555,0,0,0,0,low-risk
37560,0,0,0,0,low-risk
37593,12,179,233,424,high-risk
37596,12,167,187,366,high-risk
3760,0,0,0,0,low-risk
37613,0,0,0,0,low-risk
37618,12,98,125,235,medium-low-risk
37633,21,106,157,284,medium-high-risk
3765,12,111,221,344,high-risk
37652,0,0,0,0,low-risk
37653,12,166,209,387,high-risk
37671,12,155,178,345,high-risk
37675,0,0,0,0,low-risk
37681,0,0,0,0,low-risk
37684,12,89,128,229,medium-low-risk
37687,16,155,196,367,high-risk
37688,29,129,172,330,high-risk
37707,41,166,221,428,high-risk
37727,31,93,160,284,medium-high-risk
37731,0,0,0,0,low-risk
37739,16,106,160,282,medium-high-risk
3776,12,129,108,249,medium-high-risk
37762,0,0,0,0,low-risk
37764,18,183,206,407,high-risk
37765,16,136,199,351,high-risk
37766,0,0,0,0,low-risk
37775,12,101,143,256,medium-high-risk
37783,12,84,102,198,medium-low-risk
37801,0,0,0,0,low-risk
37802,0,0,0,0,low-risk
37805,0,0,0,0,low-risk
37807,0,0,0,0,low-risk
37817,0,0,0,0,low-risk
37820,41,184,213,438,high-risk
37822,0,0,0,0,low-risk
37827,21,137,179,337,high-risk
37832,12,128,167,307,medium-high-risk
37855,0,0,0,0,low-risk
3786,12,125,150,287,medium-high-risk
37882,24,90,150,264,medium-high-risk
37884,0,0,0,0,low-risk
3789,0,0,0,0,low-risk
37897,12,132,214,358,high-risk
37901,12,128,141,281,medium-high-risk
37910,0,0,0,0,low-risk
37913,12,105,147,264,medium-high-risk
37918,19,117,152,288,medium-high-risk
37919,14,99,141,254,medium-high-risk
37922,12,157,195,364,high-risk
37923,0,0,0,0,low-risk
37924,12,147,98,257,medium-high-risk
37931,0,0,0,0,low-risk
37934,12,162,162,336,high-risk
37949,12,170,244,426,high-risk
3795,14,126,219,359,high-risk
37953,12,99,131,242,medium-low-risk
37963,12,154,188,354,high-risk
37969,0,0,0,0,low-risk
37978,41,158,209,408,high-risk
37984,0,0,0,0,low-risk
37988,12,172,187,371,high-risk
37990,12,181,229,422,high-risk
37992,0,0,0,0,low-risk
37998,0,0,0,0,low-risk
3800,20,144,193,357,high-risk
38018,13,136,221,370,high-risk
38019,0,0,0,0,low-risk
38020,18,196,261,475,high-risk
38026,12,133,185,330,high-risk
38031,12,154,186,352,high-risk
38032,0,0,0,0,low-risk
38044,0,0,0,0,low-risk
38045,0,0,0,0,low-risk
38048,54,214,291,559,high-risk
38051,18,72,118,208,medium-low-risk
38056,12,155,191,358,high-risk
38057,20,106,153,279,medium-high-risk
38062,0,0,0,0,low-risk
38067,12,130,157,299,medium-high-risk
38084,0,0,0,0,low-risk
38086,15,93,140,248,medium-high-risk
38095,0,0,0,0,low-risk
38102,0,0,0,0,low-risk
38106,0,0,0,0,low-risk
38109,0,0,0,0,low-risk
38111,0,0,0,0,low-risk
38114,12,170,207,389,high-risk
38120,15,107,156,278,medium-high-risk
38136,12,88,102,202,medium-low-risk
38145,12,111,147,270,medium-high-risk
38147,0,0,0,0,low-risk
38171,18,136,219,373,high-risk
3818,0,0,0,0,low-risk
38181,0,0,0,0,low-risk
38184,24,123,165,312,medium-high-risk
38187,12,98,118,228,medium-low-risk
38188,39,133,210,382,high-risk
38193,12,89,116,217,medium-low-risk
38199,21,148,197,366,high-risk
38201,0,0,0,0,low-risk
38203,0,0,0,0,low-risk
38214,12,148,282,442,high-risk
38216,0,0,0,0,low-risk
38219,0,0,0,0,low-risk
3822,34,127,193,354,high-risk
38226,12,180,189,381,high-risk
38232,12,133,150,295,medium-high-risk
38240,12,124,215,351,high-risk
38247,12,153,166,331,high-risk
38250,0,0,0,0,low-risk
38288,12,144,209,365,high-risk
38289,12,112,149,273,medium-high-risk
38292,14,100,138,252,medium-high-risk
38298,0,0,0,0,low-risk
38302,18,145,210,373,high-risk
38315,42,152,201,395,high-risk
38317,0,0,0,0,low-risk
38320,12,113,121,246,medium-high-risk
38353,0,0,0,0,low-risk
38359,11,143,185,339,high-risk
3836,0,0,0,0,low-risk
38364,0,0,0,0,low-risk
38365,12,100,131,243,medium-low-risk
38369,19,110,204,333,high-risk
38372,12,150,182,344,high-risk
38378,0,0,0,0,low-risk
3838,12,112,134,258,medium-high-risk
38394,12,158,235,405,high-risk
38396,0,0,0,0,low-risk
38398,0,0,0,0,low-risk
38408,12,124,144,280,medium-high-risk
38417,0,0,0,0,low-risk
38419,26,116,188,330,high-risk
38429,14,113,156,283,medium-high-risk
38430,0,0,0,0,low-risk
38433,19,99,160,278,medium-high-risk
38435,15,103,175,293,medium-high-risk
38447,0,0,0,0,low-risk
38448,12,148,188,348,high-risk
38455,12,139,214,365,high-risk
38456,0,0,0,0,low-risk
38459,0,0,0,0,low-risk
38461,25,111,158,294,medium-high-risk
38470,0,0,0,0,low-risk
38476,11,175,194,380,high-risk
38480,42,122,160,324,medium-high-risk
3849,0,0,0,0,low-risk
38494,12,167,209,388,high-risk
38503,0,0,0,0,low-risk
38512,0,0,0,0,low-risk
38514,0,0,0,0,low-risk
38516,0,0,0,0,low-risk
38526,15,137,176,328,medium-high-risk
3853,0,0,0,0,low-risk
38533,22,132,169,323,medium-high-risk
38534,35,139,174,348,high-risk
38548,0,0,0,0,low-risk
38552,12,152,190,354,high-risk
38558,0,0,0,0,low-risk
38562,0,0,0,0,low-risk
3857,0,0,0,0,low-risk
38573,0,0,0,0,low-risk
38580,12,128,143,283,medium-high-risk
38583,11,105,100,216,medium-low-risk
38602,0,0,0,0,low-risk
38617,0,0,0,0,low-risk
38620,0,0,0,0,low-risk
38625,19,80,123,222,medium-low-risk
38646,12,172,201,385,high-risk
38651,12,173,207,392,high-risk
38652,0,0,0,0,low-risk
38656,0,0,0,0,low-risk
38659,14,140,246,400,high-risk
38663,33,142,203,378,high-risk
38674,0,0,0,0,low-risk
38677,0,0,0,0,low-risk
3868,34,164,206,404,high-risk
38686,0,0,0,0,low-risk
38687,0,0,0,0,low-risk
38707,12,163,204,379,high-risk
38709,13,164,195,372,high-risk
38711,0,0,0,0,low-risk
38712,25,148,178,351,high-risk
38719,0,0,0,0,low-risk
38731,0,0,0,0,low-risk
38736,0,0,0,0,low-risk
38742,19,117,183,319,medium-high-risk
38744,0,0,0,0,low-risk
38745,12,111,141,264,medium-high-risk
38747,12,111,101,224,medium-low-risk
38748,22,88,200,310,medium-high-risk
38759,0,0,0,0,low-risk
38764,26,131,188,345,high-risk
38770,0,0,0,0,low-risk
38780,13,110,191,314,medium-high-risk
38790,12,117,147,276,medium-high-risk
38797,12,133,162,307,medium-high-risk
3880,13,102,169,284,medium-high-risk
38803,0,0,0,0,low-risk
38807,0,0,0,0,low-risk
38813,0,0,0,0,low-risk
38820,43,165,229,437,high-risk
3884,0,0,0,0,low-risk
38841,0,0,0,0,low-risk
38858,12,125,175,312,medium-high-risk
3887,0,0,0,0,low-risk
38872,0,0,0,0,low-risk
38878,0,0,0,0,low-risk
38881,12,156,111,279,medium-high-risk
3889,0,0,0,0,low-risk
38899,0,0,0,0,low-risk
3890,54,136,190,380,high-risk
38905,21,84,131,236,medium-low-risk
38906,12,163,193,368,high-risk
38917,0,0,0,0,low-risk
38927,0,0,0,0,low-risk
38930,0,0,0,0,low-risk
3896,33,172,228,433,high-risk
38962,15,119,171,305,medium-high-risk
38966,38,124,170,332,high-risk
38968,0,0,0,0,low-risk
38982,12,115,150,277,medium-high-risk
38983,26,144,212,382,high-risk
38984,12,166,175,353,high-risk
38986,12,122,215,349,high-risk
39000,0,0,0,0,low-risk
39009,0,0,0,0,low-risk
39017,20,102,169,291,medium-high-risk
39019,0,0,0,0,low-risk
39024,0,0,0,0,low-risk
39027,15,153,229,397,high-risk
39033,12,156,182,350,high-risk
39034,12,129,142,283,medium-high-risk
39037,12,109,155,276,medium-high-risk
39040,12,122,156,290,medium-high-risk
3905,12,108,217,337,high-risk
39054,0,0,0,0,low-risk
39057,0,0,0,0,low-risk
39063,0,0,0,0,low-risk
39065,0,0,0,0,low-risk
3907,20,105,156,281,medium-high-risk
39074,0,0,0,0,low-risk
39077,0,0,0,0,low-risk
39078,17,213,150,380,high-risk
39083,28,135,177,340,high-risk
39097,12,132,84,228,medium-low-risk
39101,27,124,180,331,high-risk
39108,13,158,232,403,high-risk
39111,21,136,150,307,medium-high-risk
39119,12,117,143,272,medium-high-risk
39125,0,0,0,0,low-risk
39129,12,118,127,257,medium-high-risk
3913,0,0,0,0,low-risk
39131,28,131,172,331,high-risk
39132,0,0,0,0,low-risk
39140,0,0,0,0,low-risk
39142,0,0,0,0,low-risk
39151,13,150,204,367,high-risk
39158,0,0,0,0,low-risk
39160,12,132,147,291,medium-high-risk
39179,0,0,0,0,low-risk
39180,0,0,0,0,low-risk
39181,0,0,0,0,low-risk
39184,0,0,0,0,low-risk
39190,12,118,138,268,medium-high-risk
39192,14,136,217,367,high-risk
39194,0,0,0,0,low-risk
3921,0,0,0,0,low-risk
39218,42,116,151,309,medium-high-risk
3922,0,0,0,0,low-risk
39230,0,0,0,0,low-risk
39233,26,123,179,328,medium-high-risk
39239,17,132,159,308,medium-high-risk
39241,0,0,0,0,low-risk
39252,31,121,173,325,medium-high-risk
39255,0,0,0,0,low-risk
39262,29,91,154,274,medium-high-risk
39282,0,0,0,0,low-risk
39296,0,0,0,0,low-risk
39298,23,163,218,404,high-risk
39300,20,112,120,252,medium-high-risk
39301,13,147,221,381,high-risk
39315,12,116,135,263,medium-high-risk
39316,13,89,139,241,medium-low-risk
39319,0,0,0,0,low-risk
39321,20,117,160,297,medium-high-risk
39326,0,0,0,0,low-risk
39327,0,0,0,0,low-risk
39335,12,114,157,283,medium-high-risk
3934,12,123,158,293,medium-high-risk
39347,12,133,154,299,medium-high-risk
39350,0,0,0,0,low-risk
39354,14,87,104,205,medium-low-risk
39369,0,0,0,0,low-risk
39370,0,0,0,0,low-risk
39372,29,136,167,332,high-risk
39377,0,0,0,0,low-risk
39380,0,0,0,0,low-risk
39383,27,119,170,316,medium-high-risk
39387,0,0,0,0,low-risk
39388,12,143,167,322,medium-high-risk
3939,15,117,239,371,high-risk
39390,0,0,0,0,low-risk
39399,12,201,117,330,high-risk
39416,15,83,116,214,medium-low-risk
39417,0,0,0,0,low-risk
39427,12,82,81,175,medium-low-risk
39437,30,149,180,359,high-risk
39442,0,0,0,0,low-risk
39452,22,119,187,328,medium-high-risk
39464,11,137,160,308,medium-high-risk
39467,15,75,106,196,medium-low-risk
39470,12,108,194,314,medium-high-risk
39483,12,178,219,409,high-risk
39495,12,111,148,271,medium-high-risk
39498,23,116,159,298,medium-high-risk
39501,0,0,0,0,low-risk
39504,0,0,0,0,low-risk
39511,23,135,183,341,high-risk
39512,0,0,0,0,low-risk
39517,0,0,0,0,low-risk
39518,12,131,191,334,high-risk
39521,12,135,161,308,medium-high-risk
39527,26,152,199,377,high-risk
39532,0,0,0,0,low-risk
39540,20,118,164,302,medium-high-risk
39543,18,189,209,416,high-risk
39551,0,0,0,0,low-risk
39555,12,108,176,296,medium-high-risk
39563,0,0,0,0,low-risk
39565,14,142,189,345,high-risk
39566,12,177,223,412,high-risk
39567,12,105,209,326,medium-high-risk
39569,0,0,0,0,low-risk
39570,0,0,0,0,low-risk
39577,12,84,76,172,medium-low-risk
3958,13,76,111,200,medium-low-risk
39583,0,0,0,0,low-risk
39589,23,186,241,450,high-risk
39595,31,168,255,454,high-risk
39596,44,152,297,493,high-risk
39597,12,132,164,308,medium-high-risk
39605,12,131,139,282,medium-high-risk
39618,33,149,232,414,high-risk
39624,0,0,0,0,low-risk
39637,12,114,166,292,medium-high-risk
39654,0,0,0,0,low-risk
39673,0,0,0,0,low-risk
39676,21,127,165,313,medium-high-risk
39679,0,0,0,0,low-risk
39680,23,84,174,281,medium-high-risk
39683,12,132,162,306,medium-high-risk
39686,0,0,0,0,low-risk
39688,12,148,174,334,high-risk
39689,0,0,0,0,low-risk
39690,12,96,155,263,medium-high-risk
39698,12,122,157,291,medium-high-risk
3970,12,119,167,298,medium-high-risk
39706,12,121,192,325,medium-high-risk
39707,12,63,84,159,medium-low-risk
39722,0,0,0,0,low-risk
39733,12,161,177,350,high-risk
39736,13,134,201,348,high-risk
39738,0,0,0,0,low-risk
39739,19,107,143,269,medium-high-risk
39754,26,143,200,369,high-risk
39760,0,0,0,0,low-risk
39764,0,0,0,0,low-risk
39779,12,147,176,335,high-risk
39780,26,161,215,402,high-risk
39782,12,117,166,295,medium-high-risk
39803,35,147,187,369,high-risk
39817,12,135,168,315,medium-high-risk
39825,0,0,0,0,low-risk
39829,30,125,188,343,high-risk
39831,0,0,0,0,low-risk
39834,12,123,160,295,medium-high-risk
39841,16,121,134,271,medium-high-risk
39860,0,0,0,0,low-risk
39877,12,133,222,367,high-risk
39880,0,0,0,0,low-risk
39889,0,0,0,0,low-risk
39893,0,0,0,0,low-risk
39895,0,0,0,0,low-risk
39898,0,0,0,0,low-risk
39906,16,132,222,370,high-risk
39927,17,134,187,338,high-risk
3993,0,0,0,0,low-risk
39936,0,0,0,0,low-risk
39937,35,135,176,346,high-risk
3994,12,104,91,207,medium-low-risk
39945,12,138,229,379,high-risk
39951,0,0,0,0,low-risk
39953,12,194,213,419,high-risk
39956,12,144,166,322,medium-high-risk
39964,0,0,0,0,low-risk
39969,0,0,0,0,low-risk
39970,12,114,131,257,medium-high-risk
39972,0,0,0,0,low-risk
39973,0,0,0,0,low-risk
39978,0,0,0,0,low-risk
39989,25,126,242,393,high-risk
39993,12,146,200,358,high-risk
40007,0,0,0,0,low-risk
40013,0,0,0,0,low-risk
40018,0,0,0,0,low-risk
40036,0,0,0,0,low-risk
40039,0,0,0,0,low-risk
40047,12,153,196,361,high-risk
40048,0,0,0,0,low-risk
40051,14,121,233,368,high-risk
40054,11,121,161,293,medium-high-risk
40061,0,0,0,0,low-risk
40080,12,119,196,327,medium-high-risk
40083,22,122,201,345,high-risk
4009,12,296,194,502,high-risk
40106,14,155,239,408,high-risk
40118,0,0,0,0,low-risk
40131,12,157,186,355,high-risk
40134,0,0,0,0,low-risk
40136,16,106,144,266,medium-high-risk
40137,41,153,214,408,high-risk
40141,12,118,211,341,high-risk
40160,12,129,99,240,medium-low-risk
40172,0,0,0,0,low-risk
4018,12,150,191,353,high-risk
40180,0,0,0,0,low-risk
40186,0,0,0,0,low-risk
40200,0,0,0,0,low-risk
40207,12,92,127,231,medium-low-risk
4021,41,128,179,348,high-risk
40215,0,0,0,0,low-risk
40225,12,124,158,294,medium-high-risk
40232,0,0,0,0,low-risk
40243,21,110,180,311,medium-high-risk
40246,37,169,212,418,high-risk
40249,39,129,166,334,high-risk
40254,12,117,139,268,medium-high-risk
40260,0,0,0,0,low-risk
40271,0,0,0,0,low-risk
40280,0,0,0,0,low-risk
40287,0,0,0,0,low-risk
40288,13,119,137,269,medium-high-risk
40289,24,101,146,271,medium-high-risk
40290,0,0,0,0,low-risk
40295,0,0,0,0,low-risk
40308,31,172,245,448,high-risk
40309,0,0,0,0,low-risk
40318,0,0,0,0,low-risk
40321,32,155,213,400,high-risk
40325,0,0,0,0,low-risk
40331,12,140,186,338,high-risk
40334,0,0,0,0,low-risk
40350,0,0,0,0,low-risk
40354,0,0,0,0,low-risk
40355,0,0,0,0,low-risk
40356,12,82,143,237,medium-low-risk
40361,0,0,0,0,low-risk
40367,12,122,219,353,high-risk
40371,22,107,149,278,medium-high-risk
40372,0,0,0,0,low-risk
40373,18,125,222,365,high-risk
40377,0,0,0,0,low-risk
40382,0,0,0,0,low-risk
40392,13,72,216,301,medium-high-risk
40396,12,104,186,302,medium-high-risk
40405,0,0,0,0,low-risk
40407,12,160,194,366,high-risk
40409,20,139,170,329,medium-high-risk
4044,12,94,112,218,medium-low-risk
40444,21,116,169,306,medium-high-risk
40451,12,126,142,280,medium-high-risk
40454,36,222,222,480,high-risk
40456,12,108,171,291,medium-high-risk
40459,12,160,204,376,high-risk
40461,27,127,159,313,medium-high-risk
4047,13,110,240,363,high-risk
40474,12,114,171,297,medium-high-risk
40482,0,0,0,0,low-risk
40494,13,141,177,331,high-risk
40495,0,0,0,0,low-risk
4051,0,0,0,0,low-risk
40518,0,0,0,0,low-risk
40519,0,0,0,0,low-risk
40521,23,157,171,351,high-risk
40532,50,149,234,433,high-risk
40536,12,149,167,328,medium-high-risk
40538,12,186,305,503,high-risk
40544,0,0,0,0,low-risk
40565,12,109,124,245,medium-high-risk
40576,12,188,233,433,high-risk
40598,12,82,112,206,medium-low-risk
40602,43,135,203,381,high-risk
40610,12,144,163,319,medium-high-risk
40623,0,0,0,0,low-risk
40627,0,0,0,0,low-risk
40629,0,0,0,0,low-risk
40632,0,0,0,0,low-risk
40634,23,116,163,302,medium-high-risk
40636,46,210,374,630,high-risk
40644,42,233,282,557,high-risk
40649,0,0,0,0,low-risk
40665,12,128,162,302,medium-high-risk
40666,0,0,0,0,low-risk
40670,0,0,0,0,low-risk
40671,0,0,0,0,low-risk
40679,12,107,143,262,medium-high-risk
40683,31,127,172,330,high-risk
40695,12,113,137,262,medium-high-risk
40706,13,151,193,357,high-risk
40716,12,160,198,370,high-risk
40728,0,0,0,0,low-risk
40735,12,122,157,291,medium-high-risk
40739,13,130,174,317,medium-high-risk
40745,25,108,157,290,medium-high-risk
40749,0,0,0,0,low-risk
40752,14,82,204,300,medium-high-risk
40765,0,0,0,0,low-risk
40771,26,94,251,371,high-risk
40775,12,124,143,279,medium-high-risk
4081,12,115,185,312,medium-high-risk
40827,18,117,168,303,medium-high-risk
40828,16,124,169,309,medium-high-risk
40829,12,157,202,371,high-risk
4083,12,129,147,288,medium-high-risk
40836,23,140,174,337,high-risk
40837,0,0,0,0,low-risk
40838,0,0,0,0,low-risk
40853,0,0,0,0,low-risk
40855,0,0,0,0,low-risk
40872,0,0,0,0,low-risk
40895,12,145,238,395,high-risk
40896,33,136,183,352,high-risk
40901,12,138,156,306,medium-high-risk
40903,13,155,198,366,high-risk
4091,0,0,0,0,low-risk
40913,13,181,225,419,high-risk
40921,12,149,190,351,high-risk
40926,28,98,141,267,medium-high-risk
40932,0,0,0,0,low-risk
40933,26,67,120,213,medium-low-risk
40940,12,83,92,187,medium-low-risk
40951,12,154,200,366,high-risk
40953,12,202,218,432,high-risk
40959,14,128,168,310,medium-high-risk
40965,16,115,167,298,medium-high-risk
40966,25,117,173,315,medium-high-risk
41000,12,128,284,424,high-risk
41011,0,0,0,0,low-risk
41027,33,136,429,598,high-risk
41032,12,105,146,263,medium-high-risk
41036,0,0,0,0,low-risk
41042,12,142,194,348,high-risk
41057,0,0,0,0,low-risk
4106,12,135,151,298,medium-high-risk
41062,0,0,0,0,low-risk
41065,0,0,0,0,low-risk
41067,13,225,144,382,high-risk
4107,24,157,187,368,high-risk
41075,12,133,171,316,medium-high-risk
41088,37,153,189,379,high-risk
41093,34,135,272,441,high-risk
41100,32,120,203,355,high-risk
41101,0,0,0,0,low-risk
41113,12,105,136,253,medium-high-risk
41117,0,0,0,0,low-risk
41125,0,0,0,0,low-risk
41130,48,148,277,473,high-risk
41138,12,148,214,374,high-risk
41142,0,0,0,0,low-risk
41147,17,105,179,301,medium-high-risk
41165,12,102,134,248,medium-high-risk
41170,27,108,151,286,medium-high-risk
41181,0,0,0,0,low-risk
41202,13,101,148,262,medium-high-risk
41205,15,153,172,340,high-risk
41208,0,0,0,0,low-risk
41209,0,0,0,0,low-risk
41217,0,0,0,0,low-risk
41218,0,0,0,0,low-risk
41230,16,110,134,260,medium-high-risk
41235,0,0,0,0,low-risk
41238,12,183,196,391,high-risk
4125,12,90,115,217,medium-low-risk
41261,0,0,0,0,low-risk
41262,0,0,0,0,low-risk
41263,0,0,0,0,low-risk
41268,0,0,0,0,low-risk
4127,0,0,0,0,low-risk
41274,0,0,0,0,low-risk
41275,31,135,175,341,high-risk
41283,12,113,132,257,medium-high-risk
41302,0,0,0,0,low-risk
41304,31,143,211,385,high-risk
41347,11,99,175,285,medium-high-risk
41357,0,0,0,0,low-risk
41359,48,136,404,588,high-risk
41360,40,123,181,344,high-risk
41369,12,132,160,304,medium-high-risk
41372,0,0,0,0,low-risk
41378,16,68,110,194,medium-low-risk
4138,0,0,0,0,low-risk
41386,15,85,144,244,medium-low-risk
41387,0,0,0,0,low-risk
41392,0,0,0,0,low-risk
41401,12,160,189,361,high-risk
41402,0,0,0,0,low-risk
41404,12,135,169,316,medium-high-risk
41407,0,0,0,0,low-risk
4141,12,121,167,300,medium-high-risk
41415,0,0,0,0,low-risk
4142,12,132,93,237,medium-low-risk
41424,0,0,0,0,low-risk
41428,0,0,0,0,low-risk
41434,14,174,327,515,high-risk
4144,0,0,0,0,low-risk
41446,0,0,0,0,low-risk
41452,0,0,0,0,low-risk
41458,12,138,171,321,medium-high-risk
41462,0,0,0,0,low-risk
41463,39,139,199,377,high-risk
41464,0,0,0,0,low-risk
41467,11,105,132,248,medium-high-risk
41469,12,164,195,371,high-risk
4148,12,155,172,339,high-risk
41482,0,0,0,0,low-risk
41486,0,0,0,0,low-risk
41487,21,105,142,268,medium-high-risk
41492,0,0,0,0,low-risk
41495,12,175,199,386,high-risk
41505,27,141,170,338,high-risk
41512,0,0,0,0,low-risk
41513,12,146,186,344,high-risk
41518,20,103,131,254,medium-high-risk
41523,18,80,134,232,medium-low-risk
4154,12,173,212,397,high-risk
41545,12,117,142,271,medium-high-risk
41546,0,0,0,0,low-risk
41555,0,0,0,0,low-risk
41560,12,117,177,306,medium-high-risk
41570,0,0,0,0,low-risk
41576,0,0,0,0,low-risk
4158,0,0,0,0,low-risk
41588,12,120,149,281,medium-high-risk
41590,12,150,186,348,high-risk
41594,21,99,228,348,high-risk
41599,0,0,0,0,low-risk
41600,0,0,0,0,low-risk
41613,0,0,0,0,low-risk
41621,25,128,201,354,high-risk
41632,0,0,0,0,low-risk
41633,0,0,0,0,low-risk
41637,0,0,0,0,low-risk
41640,0,0,0,0,low-risk
41645,0,0,0,0,low-risk
41657,12,110,141,263,medium-high-risk
41664,0,0,0,0,low-risk
41670,0,0,0,0,low-risk
41682,12,87,110,209,medium-low-risk
41684,0,0,0,0,low-risk
41688,45,97,312,454,high-risk
41704,0,0,0,0,low-risk
41707,21,162,221,404,high-risk
4171,12,75,94,181,medium-low-risk
41717,0,0,0,0,low-risk
41718,11,160,205,376,high-risk
41721,0,0,0,0,low-risk
41727,0,0,0,0,low-risk
41728,0,0,0,0,low-risk
41729,0,0,0,0,low-risk
41732,0,0,0,0,low-risk
41750,20,125,195,340,high-risk
41761,0,0,0,0,low-risk
41763,0,0,0,0,low-risk
4177,16,103,162,281,medium-high-risk
41780,0,0,0,0,low-risk
41784,12,125,145,282,medium-high-risk
41792,12,152,192,356,high-risk
41812,0,0,0,0,low-risk
41816,12,111,137,260,medium-high-risk
41824,0,0,0,0,low-risk
41830,25,154,205,384,high-risk
41833,12,127,146,285,medium-high-risk
41841,0,0,0,0,low-risk
41842,0,0,0,0,low-risk
41846,15,124,155,294,medium-high-risk
41864,14,122,157,293,medium-high-risk
41865,12,78,127,217,medium-low-risk
41873,12,143,254,409,high-risk
41879,0,0,0,0,low-risk
41889,43,168,273,484,high-risk
41893,12,97,171,280,medium-high-risk
41906,0,0,0,0,low-risk
41911,0,0,0,0,low-risk
41918,0,0,0,0,low-risk
41936,20,98,144,262,medium-high-risk
41950,39,134,191,364,high-risk
41952,15,159,219,393,high-risk
41954,0,0,0,0,low-risk
41960,0,0,0,0,low-risk
41967,16,111,217,344,high-risk
41969,0,0,0,0,low-risk
41980,12,148,167,327,medium-high-risk
41981,0,0,0,0,low-risk
41986,12,146,187,345,high-risk
41988,12,134,218,364,high-risk
41995,0,0,0,0,low-risk
42010,0,0,0,0,low-risk
42023,14,136,252,402,high-risk
42026,27,143,196,366,high-risk
42033,0,0,0,0,low-risk
42035,0,0,0,0,low-risk
42040,12,185,236,433,high-risk
42053,0,0,0,0,low-risk
42056,11,117,154,282,medium-high-risk
4206,12,186,219,417,high-risk
42065,40,109,138,287,medium-high-risk
42066,0,0,0,0,low-risk
42085,12,166,197,375,high-risk
42090,0,0,0,0,low-risk
42102,12,136,167,315,medium-high-risk
42104,16,64,82,162,medium-low-risk
42108,0,0,0,0,low-risk
4212,13,73,115,201,medium-low-risk
42123,0,0,0,0,low-risk
42131,0,0,0,0,low-risk
42134,19,172,251,442,high-risk
42141,12,131,171,314,medium-high-risk
42143,23,153,231,407,high-risk
42171,0,0,0,0,low-risk
42172,13,91,155,259,medium-high-risk
42190,0,0,0,0,low-risk
42191,0,0,0,0,low-risk
42193,42,169,234,445,high-risk
42196,23,134,191,348,high-risk
42202,0,0,0,0,low-risk
4223,0,0,0,0,low-risk
42247,13,131,203,347,high-risk
42282,0,0,0,0,low-risk
42289,12,111,153,276,medium-high-risk
42294,17,156,194,367,high-risk
42296,26,111,137,274,medium-high-risk
4230,12,85,121,218,medium-low-risk
42309,25,207,151,383,high-risk
42313,55,224,289,568,high-risk
42314,0,0,0,0,low-risk
42323,14,169,302,485,high-risk
42328,0,0,0,0,low-risk
42329,11,154,189,354,high-risk
42335,0,0,0,0,low-risk
42345,0,0,0,0,low-risk
42347,23,99,246,368,high-risk
42360,11,77,101,189,medium-low-risk
42362,0,0,0,0,low-risk
42371,12,176,205,393,high-risk
42378,0,0,0,0,low-risk
42383,12,120,203,335,high-risk
4239,12,159,176,347,high-risk
42394,12,111,141,264,medium-high-risk
42395,0,0,0,0,low-risk
42400,0,0,0,0,low-risk
42415,13,83,112,208,medium-low-risk
42418,12,104,120,236,medium-low-risk
42421,0,0,0,0,low-risk
4243,0,0,0,0,low-risk
42441,0,0,0,0,low-risk
42444,0,0,0,0,low-risk
42460,0,0,0,0,low-risk
42463,12,94,115,221,medium-low-risk
42467,0,0,0,0,low-risk
42481,0,0,0,0,low-risk
42484,12,151,84,247,medium-high-risk
42490,0,0,0,0,low-risk
42495,12,103,121,236,medium-low-risk
42497,16,169,223,408,high-risk
42508,0,0,0,0,low-risk
42509,40,77,210,327,medium-high-risk
42535,0,0,0,0,low-risk
4254,0,0,0,0,low-risk
42541,12,150,172,334,high-risk
42551,33,145,189,367,high-risk
42552,0,0,0,0,low-risk
42562,0,0,0,0,low-risk
42587,12,198,230,440,high-risk
42595,12,97,129,238,medium-low-risk
42603,12,109,161,282,medium-high-risk
42611,12,79,132,223,medium-low-risk
42616,27,163,218,408,high-risk
42621,12,132,206,350,high-risk
42630,0,0,0,0,low-risk
42637,0,0,0,0,low-risk
42638,16,112,191,319,medium-high-risk
42644,12,70,145,227,medium-low-risk
4265,28,176,278,482,high-risk
42657,0,0,0,0,low-risk
42665,12,134,144,290,medium-high-risk
42673,12,96,113,221,medium-low-risk
4269,0,0,0,0,low-risk
42704,0,0,0,0,low-risk
42725,12,141,188,341,high-risk
42726,0,0,0,0,low-risk
42733,0,0,0,0,low-risk
42740,12,152,212,376,high-risk
42749,12,121,156,289,medium-high-risk
42759,0,0,0,0,low-risk
4276,12,121,160,293,medium-high-risk
42760,0,0,0,0,low-risk
42773,12,139,161,312,medium-high-risk
42774,0,0,0,0,low-risk
4279,12,136,212,360,high-risk
42792,14,163,216,393,high-risk
42804,0,0,0,0,low-risk
42808,0,0,0,0,low-risk
42822,0,0,0,0,low-risk
42834,0,0,0,0,low-risk
42842,12,146,233,391,high-risk
42848,0,0,0,0,low-risk
42851,12,130,159,301,medium-high-risk
42858,12,132,154,298,medium-high-risk
42860,0,0,0,0,low-risk
42867,12,114,101,227,medium-low-risk
42872,0,0,0,0,low-risk
42874,0,0,0,0,low-risk
42883,0,0,0,0,low-risk
42885,12,156,195,363,high-risk
42890,0,0,0,0,low-risk
42900,17,80,115,212,medium-low-risk
42908,0,0,0,0,low-risk
42913,0,0,0,0,low-risk
42922,24,132,176,332,high-risk
42936,12,125,173,310,medium-high-risk
42951,12,131,144,287,medium-high-risk
42959,13,101,141,255,medium-high-risk
42977,16,181,244,441,high-risk
42981,17,99,149,265,medium-high-risk
42991,14,150,218,382,high-risk
42992,18,207,258,483,high-risk
42994,16,111,167,294,medium-high-risk
43006,0,0,0,0,low-risk
4301,24,122,171,317,medium-high-risk
43010,13,152,199,364,high-risk
43016,27,128,203,358,high-risk
43021,12,157,174,343,high-risk
43029,12,92,133,237,medium-low-risk
43036,12,153,192,357,high-risk
4305,16,126,180,322,medium-high-risk
43067,0,0,0,0,low-risk
43071,0,0,0,0,low-risk
43077,0,0,0,0,low-risk
43089,51,169,223,443,high-risk
4309,12,160,117,289,medium-high-risk
43093,0,0,0,0,low-risk
43106,34,161,226,421,high-risk
43109,12,159,191,362,high-risk
43115,12,119,124,255,medium-high-risk
4313,12,140,163,315,medium-high-risk
43130,12,159,194,365,high-risk
43139,0,0,0,0,low-risk
43141,12,137,295,444,high-risk
43151,0,0,0,0,low-risk
43157,13,127,237,377,high-risk
4316,0,0,0,0,low-risk
43163,12,101,116,229,medium-low-risk
43166,0,0,0,0,low-risk
43182,0,0,0,0,low-risk
43194,12,141,153,306,medium-high-risk
43198,46,135,172,353,high-risk
43203,0,0,0,0,low-risk
43215,29,161,237,427,high-risk
43217,12,139,215,366,high-risk
43221,12,119,159,290,medium-high-risk
43228,0,0,0,0,low-risk
43231,0,0,0,0,low-risk
4324,30,103,157,290,medium-high-risk
43241,12,124,167,303,medium-high-risk
43242,0,0,0,0,low-risk
43248,13,129,169,311,medium-high-risk
43249,12,165,206,383,high-risk
43261,0,0,0,0,low-risk
43269,0,0,0,0,low-risk
43281,12,205,152,369,high-risk
43295,28,132,180,340,high-risk
43311,0,0,0,0,low-risk
43313,12,121,157,290,medium-high-risk
43340,15,152,243,410,high-risk
43345,0,0,0,0,low-risk
43348,0,0,0,0,low-risk
43349,0,0,0,0,low-risk
43357,15,118,159,292,medium-high-risk
4336,12,123,214,349,high-risk
43369,13,149,168,330,high-risk
43379,36,163,194,393,high-risk
43380,12,92,105,209,medium-low-risk
43383,0,0,0,0,low-risk
43396,0,0,0,0,low-risk
43398,31,162,239,432,high-risk
43401,0,0,0,0,low-risk
43424,12,153,187,352,high-risk
4343,16,123,165,304,medium-high-risk
43432,14,104,165,283,medium-high-risk
43441,13,91,141,245,medium-high-risk
43444,0,0,0,0,low-risk
43445,0,0,0,0,low-risk
43446,0,0,0,0,low-risk
43447,23,151,207,381,high-risk
43449,0,0,0,0,low-risk
4345,0,0,0,0,low-risk
43454,0,0,0,0,low-risk
43460,0,0,0,0,low-risk
43462,0,0,0,0,low-risk
43463,12,138,229,379,high-risk
43470,16,106,123,245,medium-high-risk
43473,0,0,0,0,low-risk
43485,29,120,173,322,medium-high-risk
43487,17,115,163,295,medium-high-risk
43489,14,106,156,276,medium-high-risk
43495,0,0,0,0,low-risk
43504,12,80,94,186,medium-low-risk
43522,12,108,143,263,medium-high-risk
43524,12,113,138,263,medium-high-risk
43550,13,94,167,274,medium-high-risk
43552,0,0,0,0,low-risk
43564,0,0,0,0,low-risk
43585,0,0,0,0,low-risk
43594,13,132,227,372,high-risk
43595,12,160,176,348,high-risk
43599,12,115,152,279,medium-high-risk
43602,12,136,160,308,medium-high-risk
43611,12,133,138,283,medium-high-risk
43615,0,0,0,0,low-risk
43621,12,111,130,253,medium-high-risk
43633,0,0,0,0,low-risk
43637,12,117,114,243,medium-low-risk
43644,0,0,0,0,low-risk
43656,0,0,0,0,low-risk
43657,12,138,97,247,medium-high-risk
43659,12,132,135,279,medium-high-risk
43668,12,127,143,282,medium-high-risk
43675,28,116,165,309,medium-high-risk
43681,12,121,145,278,medium-high-risk
43683,0,0,0,0,low-risk
43700,0,0,0,0,low-risk
4371,0,0,0,0,low-risk
4372,0,0,0,0,low-risk
43734,0,0,0,0,low-risk
43736,0,0,0,0,low-risk
43744,0,0,0,0,low-risk
43747,12,167,227,406,high-risk
43749,0,0,0,0,low-risk
43775,28,116,160,304,medium-high-risk
43777,0,0,0,0,low-risk
43780,0,0,0,0,low-risk
43782,0,0,0,0,low-risk
43785,0,0,0,0,low-risk
43788,0,0,0,0,low-risk
43792,12,148,205,365,high-risk
43804,0,0,0,0,low-risk
43810,11,120,142,273,medium-high-risk
43814,24,156,200,380,high-risk
43820,0,0,0,0,low-risk
43822,0,0,0,0,low-risk
43828,0,0,0,0,low-risk
43833,0,0,0,0,low-risk
43839,17,96,131,244,medium-low-risk
43844,17,151,184,352,high-risk
43858,18,165,194,377,high-risk
4386,12,89,142,243,medium-low-risk
43861,0,0,0,0,low-risk
43868,13,143,244,400,high-risk
43870,27,154,192,373,high-risk
43875,13,109,140,262,medium-high-risk
43877,12,122,140,274,medium-high-risk
43892,0,0,0,0,low-risk
43896,12,101,140,253,medium-high-risk
43902,12,128,153,293,medium-high-risk
43904,18,102,159,279,medium-high-risk
43910,0,0,0,0,low-risk
43921,0,0,0,0,low-risk
43924,12,147,199,358,high-risk
43930,0,0,0,0,low-risk
43937,0,0,0,0,low-risk
43946,40,126,156,322,medium-high-risk
43947,30,95,255,380,high-risk
43954,0,0,0,0,low-risk
43966,12,144,174,330,high-risk
43977,53,130,255,438,high-risk
43991,0,0,0,0,low-risk
43998,50,117,165,332,high-risk
44005,12,85,104,201,medium-low-risk
44011,0,0,0,0,low-risk
44012,12,160,209,381,high-risk
4403,16,96,134,246,medium-high-risk
44034,12,100,119,231,medium-low-risk
44047,12,117,192,321,medium-high-risk
44049,16,115,183,314,medium-high-risk
44053,0,0,0,0,low-risk
44054,0,0,0,0,low-risk
44057,12,108,152,272,medium-high-risk
44068,19,159,209,387,high-risk
44069,17,174,213,404,high-risk
4407,0,0,0,0,low-risk
44074,0,0,0,0,low-risk
44080,0,0,0,0,low-risk
44081,0,0,0,0,low-risk
44083,0,0,0,0,low-risk
44089,28,180,245,453,high-risk
44091,0,0,0,0,low-risk
44096,12,74,168,254,medium-high-risk
44102,19,115,153,287,medium-high-risk
44107,12,101,107,220,medium-low-risk
44121,12,111,142,265,medium-high-risk
44128,20,104,269,393,high-risk
44131,12,133,294,439,high-risk
44133,22,148,199,369,high-risk
44144,0,0,0,0,low-risk
44151,0,0,0,0,low-risk
44155,12,170,221,403,high-risk
44159,30,191,254,475,high-risk
4416,42,137,384,563,high-risk
44174,17,95,127,239,medium-low-risk
44189,45,192,268,505,high-risk
44195,0,0,0,0,low-risk
44202,0,0,0,0,low-risk
44210,25,127,190,342,high-risk
44224,0,0,0,0,low-risk
44228,0,0,0,0,low-risk
4423,0,0,0,0,low-risk
44249,0,0,0,0,low-risk
44250,0,0,0,0,low-risk
44252,29,151,194,374,high-risk
44255,0,0,0,0,low-risk
44257,0,0,0,0,low-risk
44264,0,0,0,0,low-risk
44269,12,131,156,299,medium-high-risk
44272,0,0,0,0,low-risk
4428,24,93,164,281,medium-high-risk
44297,0,0,0,0,low-risk
44308,0,0,0,0,low-risk
44312,0,0,0,0,low-risk
44320,12,155,212,379,high-risk
44327,0,0,0,0,low-risk
44336,12,84,123,219,medium-low-risk
44346,32,165,216,413,high-risk
44350,12,87,130,229,medium-low-risk
44370,12,130,175,317,medium-high-risk
44372,0,0,0,0,low-risk
44375,0,0,0,0,low-risk
44378,12,112,138,262,medium-high-risk
44379,0,0,0,0,low-risk
44380,40,154,189,383,high-risk
44393,0,0,0,0,low-risk
44394,20,132,166,318,medium-high-risk
44407,0,0,0,0,low-risk
44408,0,0,0,0,low-risk
44409,0,0,0,0,low-risk
44423,12,102,160,274,medium-high-risk
44429,0,0,0,0,low-risk
44432,12,117,207,336,high-risk
44435,34,120,164,318,medium-high-risk
44439,0,0,0,0,low-risk
44457,19,148,251,418,high-risk
44472,12,90,121,223,medium-low-risk
44474,25,124,280,429,high-risk
44480,12,107,125,244,medium-low-risk
44483,13,99,131,243,medium-low-risk
44488,0,0,0,0,low-risk
44491,25,96,144,265,medium-high-risk
44497,19,106,145,270,medium-high-risk
44506,12,87,107,206,medium-low-risk
44509,0,0,0,0,low-risk
44517,17,126,169,312,medium-high-risk
44519,0,0,0,0,low-risk
44528,0,0,0,0,low-risk
44533,12,124,161,297,medium-high-risk
44538,0,0,0,0,low-risk
44543,24,109,162,295,medium-high-risk
44563,33,143,191,367,high-risk
44565,0,0,0,0,low-risk
44572,0,0,0,0,low-risk
44575,0,0,0,0,low-risk
44584,0,0,0,0,low-risk
44587,0,0,0,0,low-risk
44588,0,0,0,0,low-risk
44592,17,98,128,243,medium-low-risk
44607,0,0,0,0,low-risk
44608,12,161,209,382,high-risk
44619,12,123,145,280,medium-high-risk
44621,0,0,0,0,low-risk
44624,0,0,0,0,low-risk
4463,13,133,219,365,high-risk
44635,12,64,109,185,medium-low-risk
44637,0,0,0,0,low-risk
4464,0,0,0,0,low-risk
44648,12,140,204,356,high-risk
4465,12,112,131,255,medium-high-risk
44652,0,0,0,0,low-risk
44661,12,115,159,286,medium-high-risk
44670,0,0,0,0,low-risk
44674,0,0,0,0,low-risk
44678,12,109,143,264,medium-high-risk
44680,0,0,0,0,low-risk
44683,0,0,0,0,low-risk
44697,0,0,0,0,low-risk
44702,0,0,0,0,low-risk
44724,45,153,194,392,high-risk
44730,0,0,0,0,low-risk
44735,0,0,0,0,low-risk
44737,0,0,0,0,low-risk
44743,0,0,0,0,low-risk
44747,12,114,134,260,medium-high-risk
44759,0,0,0,0,low-risk
44768,19,97,132,248,medium-high-risk
44774,0,0,0,0,low-risk
44778,0,0,0,0,low-risk
44779,12,123,137,272,medium-high-risk
44797,0,0,0,0,low-risk
44807,0,0,0,0,low-risk
44813,16,89,144,249,medium-high-risk
44820,23,122,164,309,medium-high-risk
44823,0,0,0,0,low-risk
44847,12,177,215,404,high-risk
44863,13,139,198,350,high-risk
44868,14,158,193,365,high-risk
44869,0,0,0,0,low-risk
44881,0,0,0,0,low-risk
44885,0,0,0,0,low-risk
44888,12,149,186,347,high-risk
44891,0,0,0,0,low-risk
44892,20,145,199,364,high-risk
44898,13,135,171,319,medium-high-risk
4490,12,136,173,321,medium-high-risk
44909,0,0,0,0,low-risk
44910,12,138,215,365,high-risk
44911,0,0,0,0,low-risk
44912,0,0,0,0,low-risk
44927,0,0,0,0,low-risk
44929,0,0,0,0,low-risk
44938,13,150,204,367,high-risk
4494,31,126,182,339,high-risk
44959,0,0,0,0,low-risk
44964,0,0,0,0,low-risk
44968,12,105,126,243,medium-low-risk
4497,21,152,199,372,high-risk
44974,19,177,232,428,high-risk
4498,12,164,224,400,high-risk
44990,12,136,178,326,medium-high-risk
44992,31,129,267,427,high-risk
4500,0,0,0,0,low-risk
45000,15,136,257,408,high-risk
45002,0,0,0,0,low-risk
45004,0,0,0,0,low-risk
45008,0,0,0,0,low-risk
45009,0,0,0,0,low-risk
45011,0,0,0,0,low-risk
45017,16,92,142,250,medium-high-risk
45028,45,140,196,381,high-risk
45037,25,209,266,500,high-risk
45039,26,86,126,238,medium-low-risk
45059,0,0,0,0,low-risk
45065,0,0,0,0,low-risk
45068,0,0,0,0,low-risk
45069,12,80,116,208,medium-low-risk
45079,14,100,146,260,medium-high-risk
45082,0,0,0,0,low-risk
45087,26,146,188,360,high-risk
45092,34,157,196,387,high-risk
45093,12,185,217,414,high-risk
45096,13,189,362,564,high-risk
45102,12,88,127,227,medium-low-risk
45106,13,101,164,278,medium-high-risk
4511,24,160,221,405,high-risk
45115,12,127,156,295,medium-high-risk
45130,0,0,0,0,low-risk
45131,0,0,0,0,low-risk
45134,0,0,0,0,low-risk
45140,11,129,143,283,medium-high-risk
45149,49,138,274,461,high-risk
45151,0,0,0,0,low-risk
4516,18,84,119,221,medium-low-risk
45161,12,98,136,246,medium-high-risk
45164,12,133,163,308,medium-high-risk
45165,43,135,179,357,high-risk
45170,0,0,0,0,low-risk
4518,14,125,164,303,medium-high-risk
45181,0,0,0,0,low-risk
45194,0,0,0,0,low-risk
45199,12,148,109,269,medium-high-risk
45207,28,136,223,387,high-risk
45208,22,133,165,320,medium-high-risk
45214,33,117,167,317,medium-high-risk
45219,14,100,150,264,medium-high-risk
45223,0,0,0,0,low-risk
45228,0,0,0,0,low-risk
45230,12,141,152,305,medium-high-risk
45235,0,0,0,0,low-risk
45237,12,237,153,402,high-risk
4526,12,155,191,358,high-risk
45265,0,0,0,0,low-risk
45266,0,0,0,0,low-risk
45270,0,0,0,0,low-risk
45275,0,0,0,0,low-risk
45282,12,157,193,362,high-risk
45292,17,117,148,282,medium-high-risk
45295,19,114,196,329,medium-high-risk
45309,44,113,157,314,medium-high-risk
45311,12,103,114,229,medium-low-risk
45323,0,0,0,0,low-risk
45324,0,0,0,0,low-risk
45331,21,188,313,522,high-risk
45334,12,116,162,290,medium-high-risk
45355,29,94,134,257,medium-high-risk
45375,13,110,135,258,medium-high-risk
45382,0,0,0,0,low-risk
45394,0,0,0,0,low-risk
45407,0,0,0,0,low-risk
45415,0,0,0,0,low-risk
45421,12,122,169,303,medium-high-risk
45429,0,0,0,0,low-risk
4543,0,0,0,0,low-risk
45432,33,166,198,397,high-risk
45454,37,149,193,379,high-risk
45458,0,0,0,0,low-risk
45476,12,117,131,260,medium-high-risk
45477,38,162,247,447,high-risk
4548,12,111,143,266,medium-high-risk
45481,13,119,161,293,medium-high-risk
45487,17,87,137,241,medium-low-risk
4549,16,129,164,309,medium-high-risk
45501,0,0,0,0,low-risk
45508,0,0,0,0,low-risk
45512,18,147,177,342,high-risk
45518,12,126,216,354,high-risk
45528,44,239,229,512,high-risk
45534,0,0,0,0,low-risk
45539,0,0,0,0,low-risk
45549,12,175,305,492,high-risk
4555,17,199,167,383,high-risk
45550,12,167,200,379,high-risk
45552,0,0,0,0,low-risk
45553,12,106,145,263,medium-high-risk
45569,0,0,0,0,low-risk
45570,12,126,281,419,high-risk
4558,12,178,218,408,high-risk
45582,12,121,137,270,medium-high-risk
4559,15,88,168,271,medium-high-risk
45599,12,143,216,371,high-risk
45606,22,99,165,286,medium-high-risk
45610,0,0,0,0,low-risk
45620,11,121,163,295,medium-high-risk
45627,16,83,122,221,medium-low-risk
45632,0,0,0,0,low-risk
45637,0,0,0,0,low-risk
45638,0,0,0,0,low-risk
45642,12,88,131,231,medium-low-risk
45648,14,145,224,383,high-risk
45652,0,0,0,0,low-risk
45667,0,0,0,0,low-risk
45668,0,0,0,0,low-risk
45683,0,0,0,0,low-risk
45685,13,162,214,389,high-risk
45692,21,77,125,223,medium-low-risk
45699,0,0,0,0,low-risk
45700,12,145,171,328,medium-high-risk
45702,12,116,157,285,medium-high-risk
45705,15,106,144,265,medium-high-risk
45706,0,0,0,0,low-risk
4571,12,126,150,288,medium-high-risk
45712,18,122,175,315,medium-high-risk
4572,13,146,242,401,high-risk
45723,0,0,0,0,low-risk
45728,13,99,153,265,medium-high-risk
45745,29,132,370,531,high-risk
45748,21,153,253,427,high-risk
4576,0,0,0,0,low-risk
45765,0,0,0,0,low-risk
45771,0,0,0,0,low-risk
45772,12,116,112,240,medium-low-risk
45774,12,121,130,263,medium-high-risk
45786,0,0,0,0,low-risk
45799,12,150,158,320,medium-high-risk
45800,31,124,181,336,high-risk
45813,0,0,0,0,low-risk
45821,48,182,240,470,high-risk
45835,13,124,221,358,high-risk
45836,12,142,170,324,medium-high-risk
4584,0,0,0,0,low-risk
4585,24,159,221,404,high-risk
45850,19,149,190,358,high-risk
45857,12,173,203,388,high-risk
45873,0,0,0,0,low-risk
45887,0,0,0,0,low-risk
45890,18,138,205,361,high-risk
45895,12,118,126,256,medium-high-risk
45901,16,142,193,351,high-risk
45906,12,125,207,344,high-risk
45909,18,164,216,398,high-risk
45915,27,104,150,281,medium-high-risk
45917,12,182,203,397,high-risk
45924,12,95,105,212,medium-low-risk
45935,0,0,0,0,low-risk
45943,0,0,0,0,low-risk
45945,22,144,203,369,high-risk
45952,12,115,142,269,medium-high-risk
45964,0,0,0,0,low-risk
45975,0,0,0,0,low-risk
45979,32,135,179,346,high-risk
45980,13,145,202,360,high-risk
46012,0,0,0,0,low-risk
46060,24,100,142,266,medium-high-risk
46071,12,141,183,336,high-risk
46074,25,205,260,490,high-risk
46076,0,0,0,0,low-risk
46088,20,146,195,361,high-risk
46103,0,0,0,0,low-risk
46112,0,0,0,0,low-risk
46122,15,79,121,215,medium-low-risk
46129,23,152,220,395,high-risk
46131,12,107,137,256,medium-high-risk
46134,22,160,202,384,high-risk
46137,0,0,0,0,low-risk
46138,0,0,0,0,low-risk
4614,13,127,172,312,medium-high-risk
46143,12,170,183,365,high-risk
46150,37,150,190,377,high-risk
46161,13,121,157,291,medium-high-risk
46170,0,0,0,0,low-risk
46174,0,0,0,0,low-risk
46182,0,0,0,0,low-risk
46184,12,124,139,275,medium-high-risk
46185,12,129,165,306,medium-high-risk
4621,24,114,150,288,medium-high-risk
46217,12,111,157,280,medium-high-risk
46220,0,0,0,0,low-risk
46226,0,0,0,0,low-risk
46227,0,0,0,0,low-risk
4623,28,184,275,487,high-risk
46230,0,0,0,0,low-risk
46232,0,0,0,0,low-risk
46234,12,115,161,288,medium-high-risk
46251,0,0,0,0,low-risk
46268,12,143,169,324,medium-high-risk
46271,0,0,0,0,low-risk
46294,0,0,0,0,low-risk
4630,0,0,0,0,low-risk
46314,0,0,0,0,low-risk
46315,12,94,104,210,medium-low-risk
46317,12,93,124,229,medium-low-risk
46319,16,126,157,299,medium-high-risk
46326,0,0,0,0,low-risk
46330,0,0,0,0,low-risk
46343,18,93,157,268,medium-high-risk
46350,0,0,0,0,low-risk
46351,36,149,218,403,high-risk
46356,0,0,0,0,low-risk
46358,12,198,150,360,high-risk
46365,0,0,0,0,low-risk
46376,12,107,113,232,medium-low-risk
46379,0,0,0,0,low-risk
46381,0,0,0,0,low-risk
46396,0,0,0,0,low-risk
46400,17,125,203,345,high-risk
46405,0,0,0,0,low-risk
46411,12,76,120,208,medium-low-risk
46412,12,179,208,399,high-risk
46413,12,88,134,234,medium-low-risk
46421,14,197,237,448,high-risk
46422,0,0,0,0,low-risk
46451,27,149,207,383,high-risk
46467,0,0,0,0,low-risk
46472,0,0,0,0,low-risk
46494,12,124,137,273,medium-high-risk
46507,12,114,152,278,medium-high-risk
4651,13,105,153,271,medium-high-risk
46512,0,0,0,0,low-risk
46516,40,101,234,375,high-risk
46519,33,129,191,353,high-risk
46530,0,0,0,0,low-risk
46534,0,0,0,0,low-risk
46537,16,75,106,197,medium-low-risk
46538,13,153,188,354,high-risk
46539,12,117,168,297,medium-high-risk
46540,12,140,155,307,medium-high-risk
46545,38,126,183,347,high-risk
46548,17,103,134,254,medium-high-risk
4655,12,114,140,266,medium-high-risk
46551,12,124,169,305,medium-high-risk
46556,12,114,234,360,high-risk
46557,12,142,175,329,medium-high-risk
46565,15,93,151,259,medium-high-risk
46578,12,192,223,427,high-risk
46580,26,130,218,374,high-risk
46591,23,107,158,288,medium-high-risk
46605,12,140,180,332,high-risk
46609,17,106,147,270,medium-high-risk
46610,29,151,193,373,high-risk
46616,23,110,166,299,medium-high-risk
46619,0,0,0,0,low-risk
46620,0,0,0,0,low-risk
46626,0,0,0,0,low-risk
46633,12,116,143,271,medium-high-risk
46638,15,108,145,268,medium-high-risk
46642,16,161,195,372,high-risk
46643,0,0,0,0,low-risk
46656,13,68,104,185,medium-low-risk
4666,0,0,0,0,low-risk
46660,25,118,178,321,medium-high-risk
46663,0,0,0,0,low-risk
46675,0,0,0,0,low-risk
46677,0,0,0,0,low-risk
46687,0,0,0,0,low-risk
46691,0,0,0,0,low-risk
46700,19,122,206,347,high-risk
46707,13,99,126,238,medium-low-risk
46710,12,124,155,291,medium-high-risk
46714,11,94,117,222,medium-low-risk
46722,12,134,161,307,medium-high-risk
46724,50,121,253,424,high-risk
46727,12,140,175,327,medium-high-risk
46740,12,133,173,318,medium-high-risk
46759,12,124,159,295,medium-high-risk
46779,26,144,199,369,high-risk
46788,12,94,134,240,medium-low-risk
46796,32,111,166,309,medium-high-risk
46799,28,230,209,467,high-risk
46800,0,0,0,0,low-risk
46802,12,155,230,397,high-risk
46807,0,0,0,0,low-risk
46816,20,161,225,406,high-risk
46835,12,135,152,299,medium-high-risk
46836,0,0,0,0,low-risk
46838,0,0,0,0,low-risk
46847,32,264,215,511,high-risk
46853,12,135,157,304,medium-high-risk
46854,0,0,0,0,low-risk
4686,41,144,185,370,high-risk
46860,40,113,340,493,high-risk
46870,0,0,0,0,low-risk
46872,12,98,215,325,medium-high-risk
46877,12,158,195,365,high-risk
46888,0,0,0,0,low-risk
46895,12,115,170,297,medium-high-risk
46896,19,111,155,285,medium-high-risk
4690,12,164,179,355,high-risk
46908,25,135,177,337,high-risk
4691,11,90,114,215,medium-low-risk
46911,12,153,225,390,high-risk
46921,0,0,0,0,low-risk
46930,12,77,102,191,medium-low-risk
46936,0,0,0,0,low-risk
4695,16,140,187,343,high-risk
46953,37,157,214,408,high-risk
46956,20,117,169,306,medium-high-risk
46969,0,0,0,0,low-risk
4697,12,168,236,416,high-risk
46976,0,0,0,0,low-risk
46977,12,103,130,245,medium-high-risk
46983,12,103,152,267,medium-high-risk
46986,12,172,206,390,high-risk
46993,14,142,308,464,high-risk
46994,12,76,145,233,medium-low-risk
47003,16,129,166,311,medium-high-risk
47006,29,170,225,424,high-risk
47025,12,106,141,259,medium-high-risk
47027,18,138,186,342,high-risk
47032,12,121,160,293,medium-high-risk
47034,15,121,223,359,high-risk
47040,0,0,0,0,low-risk
47041,0,0,0,0,low-risk
47050,12,139,258,409,high-risk
47070,12,145,205,362,high-risk
47078,26,134,157,317,medium-high-risk
4708,17,84,140,241,medium-low-risk
47093,0,0,0,0,low-risk
47095,0,0,0,0,low-risk
4710,38,165,231,434,high-risk
47114,12,135,132,279,medium-high-risk
47115,12,154,178,344,high-risk
47118,0,0,0,0,low-risk
47133,19,87,187,293,medium-high-risk
47138,21,161,197,379,high-risk
47140,40,140,175,355,high-risk
47141,0,0,0,0,low-risk
47142,0,0,0,0,low-risk
47153,0,0,0,0,low-risk
47158,0,0,0,0,low-risk
4717,32,162,245,439,high-risk
47170,0,0,0,0,low-risk
47173,15,125,163,303,medium-high-risk
47184,0,0,0,0,low-risk
47193,28,175,225,428,high-risk
47194,0,0,0,0,low-risk
47203,12,166,193,371,high-risk
47211,0,0,0,0,low-risk
47218,0,0,0,0,low-risk
47220,0,0,0,0,low-risk
47223,12,158,213,383,high-risk
4723,0,0,0,0,low-risk
47236,12,193,145,350,high-risk
47249,12,61,90,163,medium-low-risk
47269,0,0,0,0,low-risk
47271,55,197,244,496,high-risk
47281,0,0,0,0,low-risk
47286,32,175,241,448,high-risk
47289,0,0,0,0,low-risk
47296,23,151,195,369,high-risk
47299,12,79,125,216,medium-low-risk
47305,0,0,0,0,low-risk
47306,12,123,151,286,medium-high-risk
47309,12,213,267,492,high-risk
4731,12,113,148,273,medium-high-risk
47316,0,0,0,0,low-risk
47342,12,129,142,283,medium-high-risk
47354,12,103,165,280,medium-high-risk
47358,21,113,155,289,medium-high-risk
47369,12,175,198,385,high-risk
47374,43,156,200,399,high-risk
47377,12,99,120,231,medium-low-risk
47379,12,105,145,262,medium-high-risk
47381,28,127,183,338,high-risk
4739,12,100,150,262,medium-high-risk
47390,0,0,0,0,low-risk
4741,0,0,0,0,low-risk
47413,12,116,125,253,medium-high-risk
47421,0,0,0,0,low-risk
47424,12,134,223,369,high-risk
47426,19,117,168,304,medium-high-risk
47427,0,0,0,0,low-risk
47436,0,0,0,0,low-risk
47440,18,151,209,378,high-risk
47445,12,100,159,271,medium-high-risk
47449,0,0,0,0,low-risk
47458,13,101,133,247,medium-high-risk
47466,0,0,0,0,low-risk
47475,0,0,0,0,low-risk
47481,0,0,0,0,low-risk
47482,0,0,0,0,low-risk
47485,0,0,0,0,low-risk
47489,0,0,0,0,low-risk
47497,0,0,0,0,low-risk
47502,15,118,155,288,medium-high-risk
47507,19,78,115,212,medium-low-risk
47509,14,94,149,257,medium-high-risk
47515,12,83,115,210,medium-low-risk
47516,0,0,0,0,low-risk
47539,0,0,0,0,low-risk
4754,12,103,176,291,medium-high-risk
47552,12,116,180,308,medium-high-risk
47553,0,0,0,0,low-risk
47556,0,0,0,0,low-risk
47565,17,73,119,209,medium-low-risk
47577,0,0,0,0,low-risk
47578,34,131,208,373,high-risk
47580,12,113,104,229,medium-low-risk
47581,0,0,0,0,low-risk
47583,35,180,235,450,high-risk
47584,12,84,195,291,medium-high-risk
47588,13,144,214,371,high-risk
4759,12,152,199,363,high-risk
4760,0,0,0,0,low-risk
47602,33,180,217,430,high-risk
47604,0,0,0,0,low-risk
47607,49,109,248,406,high-risk
47617,12,151,171,334,high-risk
47631,0,0,0,0,low-risk
47645,17,134,197,348,high-risk
47653,0,0,0,0,low-risk
47654,12,103,123,238,medium-low-risk
47660,0,0,0,0,low-risk
47665,12,113,166,291,medium-high-risk
4767,16,105,168,289,medium-high-risk
47683,0,0,0,0,low-risk
47685,0,0,0,0,low-risk
47698,12,112,127,251,medium-high-risk
47699,19,139,170,328,medium-high-risk
47716,0,0,0,0,low-risk
47718,21,91,231,343,high-risk
47725,12,134,227,373,high-risk
47734,12,130,155,297,medium-high-risk
47735,12,118,172,302,medium-high-risk
47737,0,0,0,0,low-risk
47738,12,145,84,241,medium-low-risk
47740,0,0,0,0,low-risk
4775,0,0,0,0,low-risk
47750,0,0,0,0,low-risk
47774,12,141,191,344,high-risk
47798,14,159,238,411,high-risk
47810,12,180,223,415,high-risk
47819,12,75,99,186,medium-low-risk
47827,17,143,176,336,high-risk
47832,12,132,210,354,high-risk
47838,12,122,170,304,medium-high-risk
4784,0,0,0,0,low-risk
47856,12,164,214,390,high-risk
47861,12,160,199,371,high-risk
47873,12,167,202,381,high-risk
47890,13,95,157,265,medium-high-risk
47894,0,0,0,0,low-risk
47897,0,0,0,0,low-risk
47900,0,0,0,0,low-risk
47902,12,130,157,299,medium-high-risk
47907,0,0,0,0,low-risk
47911,12,107,169,288,medium-high-risk
47918,0,0,0,0,low-risk
47930,0,0,0,0,low-risk
47936,12,130,141,283,medium-high-risk
4794,0,0,0,0,low-risk
47958,0,0,0,0,low-risk
47959,18,83,143,244,medium-low-risk
47961,38,169,209,416,high-risk
47976,12,143,153,308,medium-high-risk
48001,12,118,145,275,medium-high-risk
48004,12,122,137,271,medium-high-risk
48013,12,112,138,262,medium-high-risk
48016,12,107,168,287,medium-high-risk
48020,12,128,149,289,medium-high-risk
48024,0,0,0,0,low-risk
48028,58,252,318,628,high-risk
48031,16,124,150,290,medium-high-risk
48039,0,0,0,0,low-risk
48040,0,0,0,0,low-risk
48048,12,84,108,204,medium-low-risk
48058,13,174,278,465,high-risk
48062,21,107,231,359,high-risk
48085,20,122,177,319,medium-high-risk
4809,38,154,186,378,high-risk
48095,0,0,0,0,low-risk
48098,19,114,184,317,medium-high-risk
48118,0,0,0,0,low-risk
48119,12,140,186,338,high-risk
48124,11,149,146,306,medium-high-risk
48134,0,0,0,0,low-risk
48135,18,117,262,397,high-risk
48140,0,0,0,0,low-risk
4815,30,153,209,392,high-risk
48152,0,0,0,0,low-risk
48159,13,111,139,263,medium-high-risk
48166,13,117,168,298,medium-high-risk
48173,15,121,197,333,high-risk
4818,12,87,116,215,medium-low-risk
48180,18,150,188,356,high-risk
48184,0,0,0,0,low-risk
4819,12,145,203,360,high-risk
48194,23,117,156,296,medium-high-risk
48195,12,137,184,333,high-risk
4820,22,155,212,389,high-risk
48200,49,142,170,361,high-risk
48209,0,0,0,0,low-risk
48214,0,0,0,0,low-risk
48217,12,112,159,283,medium-high-risk
48220,12,123,143,278,medium-high-risk
4823,44,150,231,425,high-risk
48233,20,103,164,287,medium-high-risk
48238,12,137,151,300,medium-high-risk
4824,12,121,136,269,medium-high-risk
48245,17,132,181,330,high-risk
4825,0,0,0,0,low-risk
48250,22,153,177,352,high-risk
48254,12,119,160,291,medium-high-risk
48258,15,119,167,301,medium-high-risk
48275,12,152,185,349,high-risk
48300,12,137,218,367,high-risk
48304,20,113,168,301,medium-high-risk
48313,0,0,0,0,low-risk
4832,17,151,193,361,high-risk
48323,12,131,146,289,medium-high-risk
48325,0,0,0,0,low-risk
48326,0,0,0,0,low-risk
48330,0,0,0,0,low-risk
48334,12,134,158,304,medium-high-risk
48342,12,109,193,314,medium-high-risk
48349,21,99,135,255,medium-high-risk
48350,0,0,0,0,low-risk
48366,0,0,0,0,low-risk
48369,0,0,0,0,low-risk
4837,12,151,243,406,high-risk
48375,12,111,129,252,medium-high-risk
4838,18,190,233,441,high-risk
48381,0,0,0,0,low-risk
48390,12,93,130,235,medium-low-risk
48396,0,0,0,0,low-risk
4840,15,130,157,302,medium-high-risk
48401,15,117,168,300,medium-high-risk
48413,27,125,200,352,high-risk
48427,0,0,0,0,low-risk
48432,35,169,308,512,high-risk
48446,12,117,145,274,medium-high-risk
48449,54,256,176,486,high-risk
48462,0,0,0,0,low-risk
48463,15,160,196,371,high-risk
48465,29,133,164,326,medium-high-risk
48473,12,123,157,292,medium-high-risk
48479,13,139,303,455,high-risk
48481,21,78,127,226,medium-low-risk
48486,0,0,0,0,low-risk
48490,21,207,244,472,high-risk
48491,0,0,0,0,low-risk
48500,0,0,0,0,low-risk
48522,19,114,268,401,high-risk
48525,0,0,0,0,low-risk
48529,12,123,137,272,medium-high-risk
48530,12,94,124,230,medium-low-risk
48531,15,70,95,180,medium-low-risk
48533,0,0,0,0,low-risk
4854,0,0,0,0,low-risk
48553,12,122,152,286,medium-high-risk
48556,0,0,0,0,low-risk
48558,12,177,224,413,high-risk
48563,12,120,183,315,medium-high-risk
48578,0,0,0,0,low-risk
48579,12,112,135,259,medium-high-risk
48590,0,0,0,0,low-risk
4861,38,121,178,337,high-risk
48619,0,0,0,0,low-risk
48620,12,96,139,247,medium-high-risk
48645,11,100,133,244,medium-low-risk
48650,40,124,169,333,high-risk
48652,48,133,204,385,high-risk
48655,16,115,180,311,medium-high-risk
48662,12,117,202,331,high-risk
48666,0,0,0,0,low-risk
48682,0,0,0,0,low-risk
48685,15,113,199,327,medium-high-risk
48689,0,0,0,0,low-risk
48693,12,257,243,512,high-risk
48694,24,169,226,419,high-risk
48696,0,0,0,0,low-risk
4871,15,122,180,317,medium-high-risk
48710,0,0,0,0,low-risk
48713,25,96,134,255,medium-high-risk
48714,25,107,150,282,medium-high-risk
48715,0,0,0,0,low-risk
48723,0,0,0,0,low-risk
48728,0,0,0,0,low-risk
48729,0,0,0,0,low-risk
48732,16,139,174,329,medium-high-risk
48749,0,0,0,0,low-risk
4875,12,100,111,223,medium-low-risk
48753,24,129,184,337,high-risk
48760,12,125,159,296,medium-high-risk
48764,22,105,157,284,medium-high-risk
48788,12,148,206,366,high-risk
48791,12,124,140,276,medium-high-risk
48797,12,142,163,317,medium-high-risk
4880,0,0,0,0,low-risk
48804,0,0,0,0,low-risk
48806,0,0,0,0,low-risk
48807,20,118,178,316,medium-high-risk
48810,12,121,151,284,medium-high-risk
48823,12,118,141,271,medium-high-risk
48826,0,0,0,0,low-risk
48845,0,0,0,0,low-risk
4885,0,0,0,0,low-risk
48853,26,133,154,313,medium-high-risk
48864,0,0,0,0,low-risk
48865,0,0,0,0,low-risk
48869,0,0,0,0,low-risk
48872,12,110,128,250,medium-high-risk
48876,0,0,0,0,low-risk
4888,12,206,141,359,high-risk
48894,12,134,204,350,high-risk
48895,0,0,0,0,low-risk
48898,0,0,0,0,low-risk
48900,30,160,216,406,high-risk
48906,0,0,0,0,low-risk
48915,12,104,148,264,medium-high-risk
48917,12,114,147,273,medium-high-risk
48924,41,194,337,572,high-risk
48935,47,190,363,600,high-risk
48936,0,0,0,0,low-risk
48941,0,0,0,0,low-risk
48948,0,0,0,0,low-risk
48950,13,167,220,400,high-risk
48951,0,0,0,0,low-risk
48952,12,98,125,235,medium-low-risk
48962,0,0,0,0,low-risk
4898,35,132,174,341,high-risk
48993,17,141,164,322,medium-high-risk
48994,12,87,153,252,medium-high-risk
48997,12,140,168,320,medium-high-risk
48998,0,0,0,0,low-risk
49005,20,137,160,317,medium-high-risk
49010,15,141,179,335,high-risk
49016,12,133,167,312,medium-high-risk
49017,0,0,0,0,low-risk
49022,38,245,232,515,high-risk
49026,23,137,173,333,high-risk
4903,13,91,115,219,medium-low-risk
4905,12,150,139,301,medium-high-risk
4906,0,0,0,0,low-risk
49068,0,0,0,0,low-risk
49073,0,0,0,0,low-risk
49074,0,0,0,0,low-risk
4908,0,0,0,0,low-risk
49080,0,0,0,0,low-risk
49092,27,102,223,352,high-risk
49094,12,121,134,267,medium-high-risk
49100,0,0,0,0,low-risk
49118,0,0,0,0,low-risk
49125,12,74,103,189,medium-low-risk
49136,13,158,172,343,high-risk
49137,13,121,186,320,medium-high-risk
49145,17,97,147,261,medium-high-risk
49146,0,0,0,0,low-risk
49149,12,146,192,350,high-risk
49153,34,128,154,316,medium-high-risk
49161,12,111,143,266,medium-high-risk
49169,0,0,0,0,low-risk
49174,33,164,188,385,high-risk
49200,12,146,180,338,high-risk
49205,13,127,233,373,high-risk
49207,0,0,0,0,low-risk
49210,0,0,0,0,low-risk
49212,0,0,0,0,low-risk
49221,0,0,0,0,low-risk
49222,20,150,183,353,high-risk
49225,13,72,115,200,medium-low-risk
49227,0,0,0,0,low-risk
49242,0,0,0,0,low-risk
49245,12,113,168,293,medium-high-risk
49246,12,154,214,380,high-risk
49261,28,127,169,324,medium-high-risk
49267,14,112,183,309,medium-high-risk
49268,0,0,0,0,low-risk
49284,12,156,244,412,high-risk
49285,14,145,196,355,high-risk
49289,12,148,183,343,high-risk
4930,12,162,245,419,high-risk
49301,19,171,232,422,high-risk
49307,33,118,140,291,medium-high-risk
49308,12,88,112,212,medium-low-risk
4931,12,123,145,280,medium-high-risk
49315,0,0,0,0,low-risk
49323,0,0,0,0,low-risk
49326,12,125,155,292,medium-high-risk
49327,0,0,0,0,low-risk
49331,17,120,169,306,medium-high-risk
49343,12,181,180,373,high-risk
49374,0,0,0,0,low-risk
49386,15,191,219,425,high-risk
49387,12,95,124,231,medium-low-risk
49388,27,121,172,320,medium-high-risk
49397,0,0,0,0,low-risk
49398,12,123,188,323,medium-high-risk
49420,18,95,127,240,medium-low-risk
49421,12,92,102,206,medium-low-risk
49433,11,101,150,262,medium-high-risk
49434,0,0,0,0,low-risk
49435,0,0,0,0,low-risk
49436,12,164,197,373,high-risk
49443,12,105,166,283,medium-high-risk
49444,0,0,0,0,low-risk
49455,0,0,0,0,low-risk
49471,0,0,0,0,low-risk
49480,14,139,185,338,high-risk
49484,0,0,0,0,low-risk
49496,0,0,0,0,low-risk
49499,12,137,170,319,medium-high-risk
49505,14,109,220,343,high-risk
49512,0,0,0,0,low-risk
49531,12,109,151,272,medium-high-risk
49536,19,143,173,335,high-risk
49541,16,111,154,281,medium-high-risk
49542,45,150,193,388,high-risk
4955,12,90,145,247,medium-high-risk
49565,0,0,0,0,low-risk
49569,46,131,172,349,high-risk
49570,0,0,0,0,low-risk
4958,12,166,212,390,high-risk
49586,12,80,98,190,medium-low-risk
49589,15,124,172,311,medium-high-risk
49601,0,0,0,0,low-risk
49602,14,73,121,208,medium-low-risk
49604,12,106,131,249,medium-high-risk
49609,12,143,167,322,medium-high-risk
49617,12,142,155,309,medium-high-risk
49619,12,147,166,325,medium-high-risk
49628,37,68,208,313,medium-high-risk
49637,0,0,0,0,low-risk
49641,0,0,0,0,low-risk
49656,0,0,0,0,low-risk
49658,12,95,104,211,medium-low-risk
49659,12,167,237,416,high-risk
49672,0,0,0,0,low-risk
49673,15,107,155,277,medium-high-risk
49682,0,0,0,0,low-risk
49687,0,0,0,0,low-risk
49690,18,114,152,284,medium-high-risk
49695,0,0,0,0,low-risk
49699,39,129,179,347,high-risk
49703,0,0,0,0,low-risk
49704,12,100,112,224,medium-low-risk
49705,12,130,155,297,medium-high-risk
49718,0,0,0,0,low-risk
49730,12,133,185,330,high-risk
49733,0,0,0,0,low-risk
49739,12,120,153,285,medium-high-risk
49759,19,120,216,355,high-risk
4976,25,91,133,249,medium-high-risk
49762,12,110,138,260,medium-high-risk
49766,0,0,0,0,low-risk
49776,12,106,169,287,medium-high-risk
49781,0,0,0,0,low-risk
49782,25,176,215,416,high-risk
49786,12,97,199,308,medium-high-risk
49789,0,0,0,0,low-risk
49795,0,0,0,0,low-risk
49800,0,0,0,0,low-risk
49807,0,0,0,0,low-risk
49808,20,155,228,403,high-risk
49812,12,117,154,283,medium-high-risk
49824,12,127,165,304,medium-high-risk
49841,0,0,0,0,low-risk
49842,0,0,0,0,low-risk
49850,12,106,141,259,medium-high-risk
49854,12,93,123,228,medium-low-risk
49855,13,191,351,555,high-risk
49857,0,0,0,0,low-risk
49861,16,98,120,234,medium-low-risk
49869,0,0,0,0,low-risk
49880,28,138,166,332,high-risk
49888,14,159,218,391,high-risk
49889,36,130,177,343,high-risk
49901,26,159,173,358,high-risk
49907,0,0,0,0,low-risk
49912,0,0,0,0,low-risk
49918,0,0,0,0,low-risk
49922,0,0,0,0,low-risk
49926,0,0,0,0,low-risk
49927,20,78,142,240,medium-low-risk
4993,12,138,152,302,medium-high-risk
49948,0,0,0,0,low-risk
49949,0,0,0,0,low-risk
49951,0,0,0,0,low-risk
49965,0,0,0,0,low-risk
49973,12,102,109,223,medium-low-risk
49978,0,0,0,0,low-risk
49982,12,106,176,294,medium-high-risk
49985,12,127,176,315,medium-high-risk
49989,0,0,0,0,low-risk
49994,0,0,0,0,low-risk
50003,0,0,0,0,low-risk
50005,12,153,170,335,high-risk
50006,12,106,95,213,medium-low-risk
5001,12,122,157,291,medium-high-risk
50010,0,0,0,0,low-risk
50011,0,0,0,0,low-risk
50017,0,0,0,0,low-risk
50024,0,0,0,0,low-risk
50025,0,0,0,0,low-risk
50031,25,137,258,420,high-risk
50040,0,0,0,0,low-risk
50045,0,0,0,0,low-risk
50046,12,119,204,335,high-risk
50047,0,0,0,0,low-risk
50053,0,0,0,0,low-risk
50054,0,0,0,0,low-risk
50058,0,0,0,0,low-risk
50061,42,145,163,350,high-risk
50064,0,0,0,0,low-risk
50073,0,0,0,0,low-risk
50085,14,148,233,395,high-risk
50087,0,0,0,0,low-risk
50091,0,0,0,0,low-risk
50093,12,127,206,345,high-risk
50104,0,0,0,0,low-risk
50130,0,0,0,0,low-risk
50142,0,0,0,0,low-risk
50143,0,0,0,0,low-risk
50152,44,152,206,402,high-risk
50162,0,0,0,0,low-risk
50172,15,152,218,385,high-risk
50173,0,0,0,0,low-risk
50181,13,137,197,347,high-risk
50194,17,106,176,299,medium-high-risk
50201,0,0,0,0,low-risk
50212,13,89,143,245,medium-high-risk
50218,0,0,0,0,low-risk
50234,12,144,319,475,high-risk
50237,0,0,0,0,low-risk
50238,13,83,131,227,medium-low-risk
50247,0,0,0,0,low-risk
50262,0,0,0,0,low-risk
50268,0,0,0,0,low-risk
50279,0,0,0,0,low-risk
50280,24,147,199,370,high-risk
50287,12,133,188,333,high-risk
50289,12,129,147,288,medium-high-risk
50293,0,0,0,0,low-risk
50315,0,0,0,0,low-risk
50316,0,0,0,0,low-risk
50318,0,0,0,0,low-risk
50329,40,172,216,428,high-risk
50340,0,0,0,0,low-risk
50343,0,0,0,0,low-risk
50344,23,143,194,360,high-risk
50358,0,0,0,0,low-risk
50361,12,128,175,315,medium-high-risk
50364,0,0,0,0,low-risk
50372,0,0,0,0,low-risk
50377,0,0,0,0,low-risk
50380,0,0,0,0,low-risk
5039,11,120,218,349,high-risk
50407,24,130,187,341,high-risk
5041,0,0,0,0,low-risk
50412,37,133,201,371,high-risk
50421,12,116,177,305,medium-high-risk
50423,12,239,352,603,high-risk
50452,23,81,132,236,medium-low-risk
50454,26,109,148,283,medium-high-risk
50455,0,0,0,0,low-risk
50465,14,113,150,277,medium-high-risk
50473,0,0,0,0,low-risk
50474,24,157,194,375,high-risk
50477,15,132,226,373,high-risk
50481,20,77,160,257,medium-high-risk
50490,0,0,0,0,low-risk
50498,12,137,150,299,medium-high-risk
50503,0,0,0,0,low-risk
50511,12,90,140,242,medium-low-risk
50513,13,136,164,313,medium-high-risk
50515,12,121,223,356,high-risk
5052,0,0,0,0,low-risk
50531,13,162,298,473,high-risk
50536,15,132,188,335,high-risk
50542,0,0,0,0,low-risk
50561,13,146,235,394,high-risk
50562,23,151,206,380,high-risk
50563,12,128,166,306,medium-high-risk
5057,16,75,107,198,medium-low-risk
5058,20,127,215,362,high-risk
50582,31,133,219,383,high-risk
50584,44,128,250,422,high-risk
50587,0,0,0,0,low-risk
50603,0,0,0,0,low-risk
50618,12,164,258,434,high-risk
50620,0,0,0,0,low-risk
50628,18,132,215,365,high-risk
5063,12,105,201,318,medium-high-risk
50630,12,137,199,348,high-risk
50635,16,123,200,339,high-risk
50645,0,0,0,0,low-risk
50647,0,0,0,0,low-risk
50648,12,127,172,311,medium-high-risk
5065,0,0,0,0,low-risk
50652,0,0,0,0,low-risk
50653,0,0,0,0,low-risk
50665,0,0,0,0,low-risk
5068,12,118,132,262,medium-high-risk
50703,0,0,0,0,low-risk
50706,12,162,193,367,high-risk
50709,12,69,98,179,medium-low-risk
5071,0,0,0,0,low-risk
50712,0,0,0,0,low-risk
50723,0,0,0,0,low-risk
50725,13,119,154,286,medium-high-risk
50726,12,157,182,351,high-risk
50740,15,100,207,322,medium-high-risk
50741,12,141,168,321,medium-high-risk
50742,22,133,189,344,high-risk
50744,12,133,168,313,medium-high-risk
50781,14,182,237,433,high-risk
50783,12,136,167,315,medium-high-risk
50784,17,120,158,295,medium-high-risk
50787,0,0,0,0,low-risk
50794,0,0,0,0,low-risk
50798,0,0,0,0,low-risk
50802,0,0,0,0,low-risk
50814,0,0,0,0,low-risk
50817,38,100,190,328,medium-high-risk
50821,0,0,0,0,low-risk
5084,0,0,0,0,low-risk
5085,0,0,0,0,low-risk
50854,12,280,195,487,high-risk
50860,0,0,0,0,low-risk
50867,13,125,168,306,medium-high-risk
5087,0,0,0,0,low-risk
50873,12,110,156,278,medium-high-risk
50874,12,158,169,339,high-risk
50881,14,155,140,309,medium-high-risk
50899,12,114,201,327,medium-high-risk
50914,0,0,0,0,low-risk
50919,39,138,191,368,high-risk
50921,12,82,119,213,medium-low-risk
50927,26,130,198,354,high-risk
5093,25,120,150,295,medium-high-risk
50933,36,160,269,465,high-risk
50952,15,167,265,447,high-risk
50953,12,129,142,283,medium-high-risk
50955,19,101,166,286,medium-high-risk
5097,0,0,0,0,low-risk
50990,12,162,189,363,high-risk
50993,18,133,179,330,high-risk
51007,0,0,0,0,low-risk
51023,13,92,168,273,medium-high-risk
51027,12,146,193,351,high-risk
51029,0,0,0,0,low-risk
51051,0,0,0,0,low-risk
51059,12,89,124,225,medium-low-risk
51066,13,161,252,426,high-risk
51068,17,105,194,316,medium-high-risk
5107,0,0,0,0,low-risk
5108,55,155,244,454,high-risk
51080,0,0,0,0,low-risk
51087,12,126,150,288,medium-high-risk
51091,12,132,165,309,medium-high-risk
51094,24,93,132,249,medium-high-risk
51095,0,0,0,0,low-risk
51102,0,0,0,0,low-risk
51103,0,0,0,0,low-risk
51108,11,124,147,282,medium-high-risk
51111,12,156,186,354,high-risk
51116,0,0,0,0,low-risk
51121,0,0,0,0,low-risk
51130,0,0,0,0,low-risk
51132,34,116,173,323,medium-high-risk
51152,0,0,0,0,low-risk
51153,0,0,0,0,low-risk
51154,0,0,0,0,low-risk
51156,12,116,150,278,medium-high-risk
51162,12,89,126,227,medium-low-risk
51180,0,0,0,0,low-risk
51185,12,158,288,458,high-risk
51186,41,156,214,411,high-risk
5119,12,158,227,397,high-risk
51193,0,0,0,0,low-risk
51195,0,0,0,0,low-risk
51203,0,0,0,0,low-risk
51215,0,0,0,0,low-risk
51221,35,170,216,421,high-risk
51233,17,161,206,384,high-risk
51234,0,0,0,0,low-risk
51255,0,0,0,0,low-risk
51262,0,0,0,0,low-risk
5127,17,78,100,195,medium-low-risk
51278,0,0,0,0,low-risk
51288,12,99,138,249,medium-high-risk
51289,12,132,156,300,medium-high-risk
51290,0,0,0,0,low-risk
51291,13,137,242,392,high-risk
51292,12,151,176,339,high-risk
51294,12,90,164,266,medium-high-risk
51295,12,138,156,306,medium-high-risk
51306,12,147,186,345,high-risk
51310,33,138,203,374,high-risk
51312,0,0,0,0,low-risk
51316,0,0,0,0,low-risk
51333,0,0,0,0,low-risk
51335,31,101,137,269,medium-high-risk
51342,0,0,0,0,low-risk
51353,12,143,154,309,medium-high-risk
51359,12,115,108,235,medium-low-risk
5136,0,0,0,0,low-risk
51379,0,0,0,0,low-risk
51382,0,0,0,0,low-risk
51387,12,110,133,255,medium-high-risk
51408,12,105,155,272,medium-high-risk
5142,0,0,0,0,low-risk
51424,0,0,0,0,low-risk
51428,0,0,0,0,low-risk
51430,0,0,0,0,low-risk
51439,12,108,146,266,medium-high-risk
51442,0,0,0,0,low-risk
51445,0,0,0,0,low-risk
51450,0,0,0,0,low-risk
51465,11,139,171,321,medium-high-risk
5147,0,0,0,0,low-risk
51472,12,118,161,291,medium-high-risk
51483,0,0,0,0,low-risk
51496,0,0,0,0,low-risk
51498,0,0,0,0,low-risk
51509,12,125,165,302,medium-high-risk
51512,0,0,0,0,low-risk
51514,24,102,146,272,medium-high-risk
51517,49,109,290,448,high-risk
51520,13,141,182,336,high-risk
51542,12,98,136,246,medium-high-risk
51544,18,104,165,287,medium-high-risk
51546,12,113,79,204,medium-low-risk
51547,13,112,205,330,high-risk
51559,0,0,0,0,low-risk
51565,12,265,172,449,high-risk
51576,12,101,117,230,medium-low-risk
51585,0,0,0,0,low-risk
51590,55,140,346,541,high-risk
5160,0,0,0,0,low-risk
51601,0,0,0,0,low-risk
51627,14,112,145,271,medium-high-risk
51638,0,0,0,0,low-risk
5164,12,96,122,230,medium-low-risk
51649,0,0,0,0,low-risk
51653,21,118,163,302,medium-high-risk
51654,15,67,97,179,medium-low-risk
51666,0,0,0,0,low-risk
5167,12,84,132,228,medium-low-risk
51671,15,101,150,266,medium-high-risk
51672,0,0,0,0,low-risk
51674,15,104,192,311,medium-high-risk
51680,12,158,214,384,high-risk
51681,14,154,183,351,high-risk
51695,19,130,224,373,high-risk
51697,12,109,137,258,medium-high-risk
51698,27,104,157,288,medium-high-risk
51703,12,105,135,252,medium-high-risk
51705,17,66,117,200,medium-low-risk
51723,0,0,0,0,low-risk
51725,0,0,0,0,low-risk
5173,39,121,181,341,high-risk
51732,14,97,187,298,medium-high-risk
51736,12,142,286,440,high-risk
51737,37,147,205,389,high-risk
5174,39,160,178,377,high-risk
51751,17,217,181,415,high-risk
51752,24,133,175,332,high-risk
51763,0,0,0,0,low-risk
51766,26,124,136,286,medium-high-risk
51775,0,0,0,0,low-risk
51786,0,0,0,0,low-risk
51787,12,120,140,272,medium-high-risk
51790,12,139,163,314,medium-high-risk
51792,0,0,0,0,low-risk
51798,12,109,180,301,medium-high-risk
5180,12,107,172,291,medium-high-risk
51808,0,0,0,0,low-risk
51810,22,151,204,377,high-risk
51811,12,130,166,308,medium-high-risk
51832,0,0,0,0,low-risk
51837,24,98,145,267,medium-high-risk
51839,0,0,0,0,low-risk
5184,0,0,0,0,low-risk
51842,0,0,0,0,low-risk
51850,0,0,0,0,low-risk
51853,0,0,0,0,low-risk
51855,0,0,0,0,low-risk
51861,26,150,190,366,high-risk
51872,21,106,135,262,medium-high-risk
51877,0,0,0,0,low-risk
51889,11,120,169,300,medium-high-risk
51890,0,0,0,0,low-risk
51893,11,120,149,280,medium-high-risk
51917,0,0,0,0,low-risk
51937,19,145,242,406,high-risk
51939,0,0,0,0,low-risk
5194,0,0,0,0,low-risk
51944,0,0,0,0,low-risk
51948,0,0,0,0,low-risk
51950,12,132,155,299,medium-high-risk
51952,0,0,0,0,low-risk
51955,0,0,0,0,low-risk
51968,0,0,0,0,low-risk
51972,38,146,190,374,high-risk
51973,12,126,144,282,medium-high-risk
5198,13,75,122,210,medium-low-risk
51982,12,108,209,329,medium-high-risk
51989,14,148,222,384,high-risk
51992,0,0,0,0,low-risk
51993,0,0,0,0,low-risk
51995,0,0,0,0,low-risk
51998,0,0,0,0,low-risk
5200,12,119,190,321,medium-high-risk
52007,12,108,129,249,medium-high-risk
52009,12,108,119,239,medium-low-risk
52012,33,181,240,454,high-risk
52014,0,0,0,0,low-risk
52015,0,0,0,0,low-risk
52029,0,0,0,0,low-risk
5203,0,0,0,0,low-risk
52040,0,0,0,0,low-risk
52052,0,0,0,0,low-risk
52054,0,0,0,0,low-risk
52056,0,0,0,0,low-risk
52071,0,0,0,0,low-risk
52073,36,94,155,285,medium-high-risk
52075,22,103,142,267,medium-high-risk
52078,12,106,130,248,medium-high-risk
52083,12,94,151,257,medium-high-risk
5210,0,0,0,0,low-risk
52108,0,0,0,0,low-risk
52113,0,0,0,0,low-risk
52120,0,0,0,0,low-risk
52122,39,141,247,427,high-risk
52123,0,0,0,0,low-risk
52124,0,0,0,0,low-risk
52132,0,0,0,0,low-risk
52141,12,166,206,384,high-risk
5215,45,136,213,394,high-risk
52150,12,161,190,363,high-risk
52153,23,95,117,235,medium-low-risk
52158,13,175,251,439,high-risk
52175,0,0,0,0,low-risk
52180,0,0,0,0,low-risk
52186,0,0,0,0,low-risk
5219,12,89,108,209,medium-low-risk
52198,0,0,0,0,low-risk
52200,12,119,166,297,medium-high-risk
5222,12,110,155,277,medium-high-risk
52223,0,0,0,0,low-risk
52235,12,146,192,350,high-risk
52238,0,0,0,0,low-risk
52239,37,125,246,408,high-risk
5224,0,0,0,0,low-risk
52242,12,149,152,313,medium-high-risk
52247,12,146,176,334,high-risk
5225,0,0,0,0,low-risk
52250,0,0,0,0,low-risk
52269,12,166,171,349,high-risk
52272,20,81,126,227,medium-low-risk
52287,12,131,161,304,medium-high-risk
52293,0,0,0,0,low-risk
52295,12,135,101,248,medium-high-risk
52302,12,125,206,343,high-risk
52306,0,0,0,0,low-risk
52316,11,156,227,394,high-risk
52317,12,108,129,249,medium-high-risk
52318,12,148,223,383,high-risk
52338,14,131,173,318,medium-high-risk
52344,0,0,0,0,low-risk
52347,12,97,130,239,medium-low-risk
52351,0,0,0,0,low-risk
52352,0,0,0,0,low-risk
52354,0,0,0,0,low-risk
52365,17,140,178,335,high-risk
5237,37,101,158,296,medium-high-risk
52377,12,122,148,282,medium-high-risk
52383,0,0,0,0,low-risk
52392,0,0,0,0,low-risk
5240,0,0,0,0,low-risk
52402,0,0,0,0,low-risk
52403,0,0,0,0,low-risk
5241,18,147,185,350,high-risk
52410,14,76,98,188,medium-low-risk
52414,0,0,0,0,low-risk
52415,15,89,131,235,medium-low-risk
52418,0,0,0,0,low-risk
52420,0,0,0,0,low-risk
52422,12,124,161,297,medium-high-risk
52425,0,0,0,0,low-risk
52462,0,0,0,0,low-risk
5247,0,0,0,0,low-risk
52472,0,0,0,0,low-risk
5248,16,140,183,339,high-risk
52481,12,152,160,324,medium-high-risk
52492,0,0,0,0,low-risk
52506,0,0,0,0,low-risk
5251,22,153,195,370,high-risk
52536,12,155,177,344,high-risk
5254,0,0,0,0,low-risk
52541,0,0,0,0,low-risk
52542,0,0,0,0,low-risk
52548,0,0,0,0,low-risk
5256,0,0,0,0,low-risk
52561,22,207,365,594,high-risk
52571,12,107,138,257,medium-high-risk
52579,0,0,0,0,low-risk
52580,12,94,131,237,medium-low-risk
52581,0,0,0,0,low-risk
52587,12,138,173,323,medium-high-risk
52589,0,0,0,0,low-risk
52591,12,113,154,279,medium-high-risk
52597,12,144,182,338,high-risk
52604,12,276,223,511,high-risk
52609,40,173,224,437,high-risk
5261,12,117,222,351,high-risk
52611,0,0,0,0,low-risk
52614,13,155,212,380,high-risk
52617,30,156,177,363,high-risk
52621,12,97,118,227,medium-low-risk
52624,0,0,0,0,low-risk
52625,40,139,179,358,high-risk
52630,0,0,0,0,low-risk
52636,30,110,170,310,medium-high-risk
52646,0,0,0,0,low-risk
52649,0,0,0,0,low-risk
52655,0,0,0,0,low-risk
52657,0,0,0,0,low-risk
52658,12,137,196,345,high-risk
5266,12,158,166,336,high-risk
52673,12,150,249,411,high-risk
52682,12,163,184,359,high-risk
52689,27,137,164,328,medium-high-risk
52704,12,100,128,240,medium-low-risk
52713,0,0,0,0,low-risk
52725,13,108,125,246,medium-high-risk
52731,14,89,145,248,medium-high-risk
52735,12,118,165,295,medium-high-risk
52738,12,150,243,405,high-risk
52742,35,106,217,358,high-risk
52746,12,116,137,265,medium-high-risk
52756,13,108,167,288,medium-high-risk
5276,12,112,211,335,high-risk
52766,22,152,240,414,high-risk
5277,0,0,0,0,low-risk
52774,12,168,193,373,high-risk
52790,20,103,169,292,medium-high-risk
52792,0,0,0,0,low-risk
52798,13,99,164,276,medium-high-risk
5280,12,155,207,374,high-risk
52800,12,93,128,233,medium-low-risk
52802,0,0,0,0,low-risk
52807,0,0,0,0,low-risk
52808,12,97,128,237,medium-low-risk
52815,12,148,204,364,high-risk
52821,0,0,0,0,low-risk
5283,23,146,204,373,high-risk
5285,12,122,146,280,medium-high-risk
52852,0,0,0,0,low-risk
52864,42,191,289,522,high-risk
52871,32,151,171,354,high-risk
52873,13,65,97,175,medium-low-risk
52874,0,0,0,0,low-risk
52879,0,0,0,0,low-risk
52881,23,194,240,457,high-risk
52883,12,115,153,280,medium-high-risk
5289,26,136,161,323,medium-high-risk
52891,0,0,0,0,low-risk
52897,12,147,164,323,medium-high-risk
5291,12,147,240,399,high-risk
52918,0,0,0,0,low-risk
5292,12,151,170,333,high-risk
52923,0,0,0,0,low-risk
52924,41,96,207,344,high-risk
52930,0,0,0,0,low-risk
52934,12,112,170,294,medium-high-risk
52943,12,131,169,312,medium-high-risk
52950,0,0,0,0,low-risk
52953,0,0,0,0,low-risk
52955,18,136,165,319,medium-high-risk
52964,12,112,112,236,medium-low-risk
52969,17,117,146,280,medium-high-risk
52970,0,0,0,0,low-risk
52977,40,139,181,360,high-risk
52978,0,0,0,0,low-risk
5298,23,134,172,329,medium-high-risk
52986,0,0,0,0,low-risk
5299,12,110,86,208,medium-low-risk
5300,12,108,196,316,medium-high-risk
53000,18,152,231,401,high-risk
53008,0,0,0,0,low-risk
53016,13,156,211,380,high-risk
53017,0,0,0,0,low-risk
5302,0,0,0,0,low-risk
53024,0,0,0,0,low-risk
5304,12,231,227,470,high-risk
53042,0,0,0,0,low-risk
53043,11,133,218,362,high-risk
53054,37,118,171,326,medium-high-risk
53055,12,166,197,375,high-risk
5306,0,0,0,0,low-risk
53061,0,0,0,0,low-risk
53062,12,133,146,291,medium-high-risk
53066,13,232,166,411,high-risk
5307,12,95,120,227,medium-low-risk
53094,0,0,0,0,low-risk
53100,18,110,141,269,medium-high-risk
53105,12,96,122,230,medium-low-risk
53112,0,0,0,0,low-risk
53116,0,0,0,0,low-risk
53125,33,141,169,343,high-risk
53136,0,0,0,0,low-risk
53137,12,100,142,254,medium-high-risk
53142,0,0,0,0,low-risk
53145,12,153,193,358,high-risk
53146,0,0,0,0,low-risk
53164,0,0,0,0,low-risk
53165,29,168,217,414,high-risk
53166,12,152,154,318,medium-high-risk
53173,12,102,142,256,medium-high-risk
53177,17,140,185,342,high-risk
53181,13,71,104,188,medium-low-risk
53182,12,137,158,307,medium-high-risk
5319,17,217,164,398,high-risk
53196,0,0,0,0,low-risk
53197,0,0,0,0,low-risk
53207,12,135,169,316,medium-high-risk
53215,14,145,220,379,high-risk
53217,26,96,137,259,medium-high-risk
5322,12,152,205,369,high-risk
53229,28,85,161,274,medium-high-risk
53235,12,146,164,322,medium-high-risk
53258,15,94,136,245,medium-high-risk
53267,0,0,0,0,low-risk
53271,18,69,125,212,medium-low-risk
53275,12,140,151,303,medium-high-risk
53280,12,163,217,392,high-risk
53282,0,0,0,0,low-risk
53310,53,232,298,583,high-risk
53315,37,163,195,395,high-risk
53317,0,0,0,0,low-risk
53329,28,114,194,336,high-risk
53335,37,116,178,331,high-risk
53354,13,99,130,242,medium-low-risk
53366,0,0,0,0,low-risk
53367,23,148,194,365,high-risk
5338,28,152,203,383,high-risk
53382,0,0,0,0,low-risk
53383,0,0,0,0,low-risk
53386,12,107,152,271,medium-high-risk
53388,14,139,262,415,high-risk
53399,12,150,177,339,high-risk
53400,0,0,0,0,low-risk
53403,0,0,0,0,low-risk
53415,0,0,0,0,low-risk
53425,12,83,105,200,medium-low-risk
53431,15,89,141,245,medium-high-risk
53440,14,90,133,237,medium-low-risk
53441,28,161,207,396,high-risk
53444,12,158,170,340,high-risk
53449,12,155,168,335,high-risk
53453,12,138,91,241,medium-low-risk
53457,12,122,166,300,medium-high-risk
5347,13,122,173,308,medium-high-risk
53471,25,174,220,419,high-risk
53472,0,0,0,0,low-risk
53475,0,0,0,0,low-risk
53481,12,121,154,287,medium-high-risk
53483,0,0,0,0,low-risk
53485,0,0,0,0,low-risk
5349,0,0,0,0,low-risk
53494,33,148,179,360,high-risk
53511,12,118,147,277,medium-high-risk
53512,12,108,128,248,medium-high-risk
53520,0,0,0,0,low-risk
53522,0,0,0,0,low-risk
53525,14,144,185,343,high-risk
53526,0,0,0,0,low-risk
53527,31,98,218,347,high-risk
5353,12,145,176,333,high-risk
53532,32,99,161,292,medium-high-risk
53534,23,151,209,383,high-risk
53536,12,123,159,294,medium-high-risk
53545,12,123,160,295,medium-high-risk
53548,0,0,0,0,low-risk
53559,0,0,0,0,low-risk
5357,56,166,211,433,high-risk
53586,12,147,148,307,medium-high-risk
53592,12,135,161,308,medium-high-risk
53605,30,122,160,312,medium-high-risk
53615,35,265,265,565,high-risk
53618,24,114,170,308,medium-high-risk
53625,12,149,162,323,medium-high-risk
53637,12,133,161,306,medium-high-risk
53639,0,0,0,0,low-risk
53659,0,0,0,0,low-risk
53660,0,0,0,0,low-risk
53667,0,0,0,0,low-risk
53668,46,149,185,380,high-risk
53674,24,95,148,267,medium-high-risk
53677,12,137,145,294,medium-high-risk
53678,12,181,235,428,high-risk
53683,0,0,0,0,low-risk
5369,0,0,0,0,low-risk
53693,12,113,154,279,medium-high-risk
53701,0,0,0,0,low-risk
53703,28,140,217,385,high-risk
53708,0,0,0,0,low-risk
53710,38,142,216,396,high-risk
53730,12,103,122,237,medium-low-risk
53734,12,118,241,371,high-risk
53737,16,118,164,298,medium-high-risk
53744,0,0,0,0,low-risk
53759,37,132,191,360,high-risk
53764,0,0,0,0,low-risk
5378,12,104,90,206,medium-low-risk
53781,12,137,124,273,medium-high-risk
53792,0,0,0,0,low-risk
53795,18,152,209,379,high-risk
53797,12,99,108,219,medium-low-risk
53800,0,0,0,0,low-risk
53806,12,121,131,264,medium-high-risk
53807,12,153,179,344,high-risk
53813,12,121,205,338,high-risk
53816,12,123,175,310,medium-high-risk
53823,0,0,0,0,low-risk
53826,12,125,129,266,medium-high-risk
53836,0,0,0,0,low-risk
53842,42,130,176,348,high-risk
53860,0,0,0,0,low-risk
53873,25,122,295,442,high-risk
53876,0,0,0,0,low-risk
53878,0,0,0,0,low-risk
5388,0,0,0,0,low-risk
53883,0,0,0,0,low-risk
53885,0,0,0,0,low-risk
53894,0,0,0,0,low-risk
53898,12,164,189,365,high-risk
53899,0,0,0,0,low-risk
53900,12,146,186,344,high-risk
5391,12,98,132,242,medium-low-risk
53917,13,99,114,226,medium-low-risk
53921,0,0,0,0,low-risk
53929,13,96,114,223,medium-low-risk
53930,0,0,0,0,low-risk
53932,12,102,100,214,medium-low-risk
53937,0,0,0,0,low-risk
5394,16,105,140,261,medium-high-risk
53940,12,138,173,323,medium-high-risk
53942,0,0,0,0,low-risk
53953,11,104,138,253,medium-high-risk
53961,0,0,0,0,low-risk
53965,0,0,0,0,low-risk
53974,27,153,204,384,high-risk
53981,14,102,151,267,medium-high-risk
53985,0,0,0,0,low-risk
53988,0,0,0,0,low-risk
53998,22,101,133,256,medium-high-risk
54013,13,80,133,226,medium-low-risk
54017,0,0,0,0,low-risk
54019,0,0,0,0,low-risk
5403,12,142,171,325,medium-high-risk
54041,0,0,0,0,low-risk
54057,0,0,0,0,low-risk
54060,0,0,0,0,low-risk
54065,0,0,0,0,low-risk
5407,0,0,0,0,low-risk
54075,12,135,103,250,medium-high-risk
54080,0,0,0,0,low-risk
54088,31,147,198,376,high-risk
54096,14,95,145,254,medium-high-risk
54102,0,0,0,0,low-risk
54117,18,132,195,345,high-risk
5412,18,144,191,353,high-risk
54123,0,0,0,0,low-risk
54126,29,126,164,319,medium-high-risk
54128,12,177,204,393,high-risk
54137,0,0,0,0,low-risk
54140,20,91,181,292,medium-high-risk
54148,14,116,149,279,medium-high-risk
54151,53,173,222,448,high-risk
54154,12,109,141,262,medium-high-risk
54155,35,212,314,561,high-risk
54159,16,73,125,214,medium-low-risk
54161,12,127,194,333,high-risk
54166,0,0,0,0,low-risk
54176,12,85,104,201,medium-low-risk
5418,0,0,0,0,low-risk
54196,0,0,0,0,low-risk
54200,22,148,198,368,high-risk
54211,0,0,0,0,low-risk
54217,12,107,152,271,medium-high-risk
54218,34,121,156,311,medium-high-risk
54219,0,0,0,0,low-risk
54221,16,140,171,327,medium-high-risk
54224,0,0,0,0,low-risk
54232,0,0,0,0,low-risk
54247,0,0,0,0,low-risk
54253,0,0,0,0,low-risk
54255,22,91,134,247,medium-high-risk
54257,0,0,0,0,low-risk
54260,12,128,151,291,medium-high-risk
54264,12,137,184,333,high-risk
54265,12,138,167,317,medium-high-risk
54273,0,0,0,0,low-risk
54286,0,0,0,0,low-risk
54289,39,129,212,380,high-risk
54294,12,195,226,433,high-risk
54297,12,140,170,322,medium-high-risk
54299,0,0,0,0,low-risk
54319,12,90,98,200,medium-low-risk
54322,12,112,224,348,high-risk
54327,12,251,183,446,high-risk
54329,13,84,139,236,medium-low-risk
54330,0,0,0,0,low-risk
54331,0,0,0,0,low-risk
54336,26,119,167,312,medium-high-risk
54340,18,121,152,291,medium-high-risk
54342,0,0,0,0,low-risk
5436,0,0,0,0,low-risk
54369,48,175,258,481,high-risk
5439,31,133,176,340,high-risk
54397,20,173,236,429,high-risk
54411,0,0,0,0,low-risk
54417,0,0,0,0,low-risk
54419,25,106,210,341,high-risk
54431,0,0,0,0,low-risk
54433,0,0,0,0,low-risk
54435,38,127,162,327,medium-high-risk
54444,0,0,0,0,low-risk
54445,22,154,177,353,high-risk
54448,0,0,0,0,low-risk
5445,0,0,0,0,low-risk
54451,12,188,207,407,high-risk
54452,0,0,0,0,low-risk
54469,26,149,224,399,high-risk
54487,12,143,176,331,high-risk
54488,12,75,113,200,medium-low-risk
54495,12,143,139,294,medium-high-risk
54496,0,0,0,0,low-risk
54499,0,0,0,0,low-risk
54508,0,0,0,0,low-risk
54512,12,112,129,253,medium-high-risk
54518,14,137,219,370,high-risk
54520,0,0,0,0,low-risk
54540,0,0,0,0,low-risk
54548,27,223,180,430,high-risk
54550,12,102,131,245,medium-high-risk
54559,12,131,174,317,medium-high-risk
54562,0,0,0,0,low-risk
5457,12,129,190,331,high-risk
5459,0,0,0,0,low-risk
54592,0,0,0,0,low-risk
54602,18,111,157,286,medium-high-risk
54617,0,0,0,0,low-risk
5462,37,130,184,351,high-risk
54640,15,113,205,333,high-risk
54641,16,131,168,315,medium-high-risk
54646,0,0,0,0,low-risk
54663,35,112,167,314,medium-high-risk
54670,0,0,0,0,low-risk
54671,0,0,0,0,low-risk
5469,0,0,0,0,low-risk
54692,0,0,0,0,low-risk
54694,0,0,0,0,low-risk
54695,0,0,0,0,low-risk
54709,44,127,306,477,high-risk
54713,0,0,0,0,low-risk
54728,14,99,141,254,medium-high-risk
54731,22,164,215,401,high-risk
54733,12,130,154,296,medium-high-risk
54740,23,99,138,260,medium-high-risk
54746,0,0,0,0,low-risk
54748,12,133,159,304,medium-high-risk
54752,12,120,160,292,medium-high-risk
54756,0,0,0,0,low-risk
54764,0,0,0,0,low-risk
54768,0,0,0,0,low-risk
54775,12,92,113,217,medium-low-risk
54778,0,0,0,0,low-risk
54790,0,0,0,0,low-risk
54791,12,152,177,341,high-risk
54803,0,0,0,0,low-risk
54818,12,163,154,329,medium-high-risk
54824,0,0,0,0,low-risk
54826,0,0,0,0,low-risk
54842,0,0,0,0,low-risk
54847,12,165,191,368,high-risk
54859,16,113,157,286,medium-high-risk
5486,38,112,187,337,high-risk
54869,12,124,158,294,medium-high-risk
54877,17,106,154,277,medium-high-risk
54886,12,99,119,230,medium-low-risk
54900,12,133,152,297,medium-high-risk
5491,12,99,106,217,medium-low-risk
54921,12,242,160,414,high-risk
54926,13,101,238,352,high-risk
5494,12,141,190,343,high-risk
54940,12,104,134,250,medium-high-risk
54941,33,109,150,292,medium-high-risk
54952,0,0,0,0,low-risk
54960,0,0,0,0,low-risk
54963,0,0,0,0,low-risk
5497,0,0,0,0,low-risk
54977,16,68,119,203,medium-low-risk
54978,12,153,182,347,high-risk
54983,12,91,123,226,medium-low-risk
5499,12,114,143,269,medium-high-risk
54995,12,139,203,354,high-risk
54998,0,0,0,0,low-risk
5500,13,100,154,267,medium-high-risk
5501,12,133,149,294,medium-high-risk
55011,16,108,142,266,medium-high-risk
55024,36,184,280,500,high-risk
5503,0,0,0,0,low-risk
55030,12,151,312,475,high-risk
55036,0,0,0,0,low-risk
55042,12,139,240,391,high-risk
55051,12,125,209,346,high-risk
55052,20,191,239,450,high-risk
55055,12,114,145,271,medium-high-risk
55056,0,0,0,0,low-risk
55061,23,145,198,366,high-risk
55069,41,151,181,373,high-risk
5507,0,0,0,0,low-risk
55071,12,117,139,268,medium-high-risk
55075,13,119,165,297,medium-high-risk
55077,15,133,167,315,medium-high-risk
55099,28,161,217,406,high-risk
5511,33,133,164,330,high-risk
55110,50,160,202,412,high-risk
55112,33,145,180,358,high-risk
55115,13,139,165,317,medium-high-risk
55119,36,108,142,286,medium-high-risk
55122,33,147,204,384,high-risk
55127,0,0,0,0,low-risk
55134,22,130,167,319,medium-high-risk
5514,22,90,159,271,medium-high-risk
5515,0,0,0,0,low-risk
55151,12,123,207,342,high-risk
55153,0,0,0,0,low-risk
55155,0,0,0,0,low-risk
55165,14,98,205,317,medium-high-risk
55170,16,138,181,335,high-risk
55179,12,114,139,265,medium-high-risk
55180,0,0,0,0,low-risk
55192,0,0,0,0,low-risk
55193,0,0,0,0,low-risk
55196,30,188,245,463,high-risk
55201,17,161,205,383,high-risk
55206,18,132,167,317,medium-high-risk
55218,12,159,205,376,high-risk
5522,31,148,206,385,high-risk
55225,0,0,0,0,low-risk
55231,0,0,0,0,low-risk
55236,16,156,194,366,high-risk
55238,0,0,0,0,low-risk
5525,18,85,128,231,medium-low-risk
55251,12,130,154,296,medium-high-risk
55254,19,158,227,404,high-risk
5527,0,0,0,0,low-risk
55270,12,134,158,304,medium-high-risk
55274,0,0,0,0,low-risk
55281,0,0,0,0,low-risk
55286,15,135,215,365,high-risk
55290,0,0,0,0,low-risk
55294,12,91,130,233,medium-low-risk
55295,0,0,0,0,low-risk
55298,0,0,0,0,low-risk
55302,12,124,142,278,medium-high-risk
55303,24,126,312,462,high-risk
55306,0,0,0,0,low-risk
55314,27,133,177,337,high-risk
55315,0,0,0,0,low-risk
55321,0,0,0,0,low-risk
55326,31,104,180,315,medium-high-risk
55328,12,131,148,291,medium-high-risk
55334,0,0,0,0,low-risk
55352,0,0,0,0,low-risk
55366,0,0,0,0,low-risk
5537,0,0,0,0,low-risk
55372,12,74,90,176,medium-low-risk
55374,12,87,112,211,medium-low-risk
55375,31,133,169,333,high-risk
5538,12,109,133,254,medium-high-risk
55380,0,0,0,0,low-risk
55393,12,133,160,305,medium-high-risk
55404,14,135,176,325,medium-high-risk
55408,0,0,0,0,low-risk
55410,0,0,0,0,low-risk
55416,12,109,139,260,medium-high-risk
55419,0,0,0,0,low-risk
55424,25,163,247,435,high-risk
55431,32,146,171,349,high-risk
55446,12,111,159,282,medium-high-risk
55449,0,0,0,0,low-risk
55457,12,134,172,318,medium-high-risk
55467,20,97,143,260,medium-high-risk
55472,17,136,164,317,medium-high-risk
55474,19,147,209,375,high-risk
55475,32,105,144,281,medium-high-risk
55481,12,140,182,334,high-risk
55482,0,0,0,0,low-risk
55485,0,0,0,0,low-risk
55489,0,0,0,0,low-risk
55491,12,145,166,323,medium-high-risk
55492,0,0,0,0,low-risk
55504,0,0,0,0,low-risk
55517,0,0,0,0,low-risk
55531,0,0,0,0,low-risk
55532,13,110,153,276,medium-high-risk
55538,31,143,176,350,high-risk
55540,33,118,153,304,medium-high-risk
55544,14,108,150,272,medium-high-risk
55547,12,174,192,378,high-risk
55548,12,144,166,322,medium-high-risk
55551,22,118,160,300,medium-high-risk
55556,0,0,0,0,low-risk
5556,40,144,186,370,high-risk
55561,12,143,159,314,medium-high-risk
55563,0,0,0,0,low-risk
55565,32,161,201,394,high-risk
55567,17,179,256,452,high-risk
55569,12,111,137,260,medium-high-risk
5558,0,0,0,0,low-risk
55586,12,186,232,430,high-risk
55587,19,88,135,242,medium-low-risk
55588,12,103,129,244,medium-low-risk
55589,0,0,0,0,low-risk
55608,0,0,0,0,low-risk
55618,13,125,254,392,high-risk
55621,12,97,136,245,medium-high-risk
55626,43,110,267,420,high-risk
55634,19,130,173,322,medium-high-risk
55641,0,0,0,0,low-risk
55646,12,150,189,351,high-risk
55651,0,0,0,0,low-risk
55655,12,75,117,204,medium-low-risk
55657,20,137,192,349,high-risk
55658,12,107,119,238,medium-low-risk
55664,0,0,0,0,low-risk
55666,0,0,0,0,low-risk
55674,0,0,0,0,low-risk
55677,0,0,0,0,low-risk
55681,12,115,161,288,medium-high-risk
55682,0,0,0,0,low-risk
55684,20,237,182,439,high-risk
55685,12,158,173,343,high-risk
5569,12,215,176,403,high-risk
55699,46,175,208,429,high-risk
55705,17,126,200,343,high-risk
55706,12,107,186,305,medium-high-risk
55709,12,99,111,222,medium-low-risk
55712,0,0,0,0,low-risk
55728,51,156,225,432,high-risk
55732,0,0,0,0,low-risk
55733,12,94,124,230,medium-low-risk
55738,0,0,0,0,low-risk
55739,12,144,178,334,high-risk
55743,0,0,0,0,low-risk
55744,16,117,156,289,medium-high-risk
55748,0,0,0,0,low-risk
55753,0,0,0,0,low-risk
55759,0,0,0,0,low-risk
55760,12,112,131,255,medium-high-risk
55772,12,135,163,310,medium-high-risk
55775,0,0,0,0,low-risk
55787,22,106,253,381,high-risk
55793,0,0,0,0,low-risk
5580,12,105,150,267,medium-high-risk
55810,16,102,150,268,medium-high-risk
55812,13,93,156,262,medium-high-risk
55815,0,0,0,0,low-risk
55817,31,150,182,363,high-risk
55827,15,136,169,320,medium-high-risk
55850,22,109,140,271,medium-high-risk
55856,12,83,118,213,medium-low-risk
55862,12,80,106,198,medium-low-risk
55868,36,240,309,585,high-risk
55873,15,160,172,347,high-risk
55874,0,0,0,0,low-risk
55877,0,0,0,0,low-risk
5589,13,82,169,264,medium-high-risk
55890,13,95,125,233,medium-low-risk
55897,0,0,0,0,low-risk
55901,0,0,0,0,low-risk
55904,12,107,142,261,medium-high-risk
55931,12,164,161,337,high-risk
55936,15,141,176,332,high-risk
55937,28,174,233,435,high-risk
55938,12,35,57,104,medium-low-risk
55944,12,160,182,354,high-risk
55952,15,67,107,189,medium-low-risk
55953,0,0,0,0,low-risk
55958,0,0,0,0,low-risk
55964,12,154,199,365,high-risk
55975,0,0,0,0,low-risk
55976,13,126,235,374,high-risk
55978,0,0,0,0,low-risk
55986,34,163,211,408,high-risk
55989,0,0,0,0,low-risk
55991,18,81,141,240,medium-low-risk
56002,17,94,143,254,medium-high-risk
56009,0,0,0,0,low-risk
56012,12,123,161,296,medium-high-risk
56024,0,0,0,0,low-risk
56044,0,0,0,0,low-risk
56045,17,137,203,357,high-risk
56051,0,0,0,0,low-risk
56064,0,0,0,0,low-risk
56065,35,109,167,311,medium-high-risk
56067,15,80,140,235,medium-low-risk
56069,12,168,279,459,high-risk
56071,12,158,216,386,high-risk
56074,12,159,180,351,high-risk
56077,12,121,200,333,high-risk
56083,12,145,190,347,high-risk
56087,12,142,176,330,high-risk
56088,0,0,0,0,low-risk
56089,0,0,0,0,low-risk
56098,0,0,0,0,low-risk
56099,12,121,138,271,medium-high-risk
56105,12,167,303,482,high-risk
56124,0,0,0,0,low-risk
56132,12,152,186,350,high-risk
56140,15,64,132,211,medium-low-risk
56147,0,0,0,0,low-risk
5615,20,94,128,242,medium-low-risk
56158,12,140,242,394,high-risk
56174,12,130,202,344,high-risk
5620,12,130,147,289,medium-high-risk
56205,0,0,0,0,low-risk
56211,0,0,0,0,low-risk
56213,0,0,0,0,low-risk
56214,0,0,0,0,low-risk
56218,12,100,121,233,medium-low-risk
56233,12,113,135,260,medium-high-risk
56235,12,111,125,248,medium-high-risk
56239,11,115,127,253,medium-high-risk
56254,12,130,178,320,medium-high-risk
56260,37,128,162,327,medium-high-risk
56265,0,0,0,0,low-risk
56284,0,0,0,0,low-risk
56293,0,0,0,0,low-risk
56303,0,0,0,0,low-risk
56306,0,0,0,0,low-risk
56313,12,185,214,411,high-risk
56325,23,134,164,321,medium-high-risk
56327,21,99,119,239,medium-low-risk
56337,12,150,183,345,high-risk
56342,0,0,0,0,low-risk
56352,12,125,207,344,high-risk
56362,0,0,0,0,low-risk
56367,0,0,0,0,low-risk
56377,24,161,207,392,high-risk
56383,0,0,0,0,low-risk
56384,12,87,125,224,medium-low-risk
56385,0,0,0,0,low-risk
56402,18,62,95,175,medium-low-risk
56404,19,132,192,343,high-risk
56405,12,120,159,291,medium-high-risk
56412,12,137,185,334,high-risk
56415,0,0,0,0,low-risk
56434,21,109,138,268,medium-high-risk
56442,0,0,0,0,low-risk
56444,12,162,202,376,high-risk
56454,0,0,0,0,low-risk
56458,13,100,141,254,medium-high-risk
56461,0,0,0,0,low-risk
56467,0,0,0,0,low-risk
56482,12,122,157,291,medium-high-risk
56485,0,0,0,0,low-risk
5650,0,0,0,0,low-risk
56527,12,110,154,276,medium-high-risk
5653,12,64,93,169,medium-low-risk
56533,13,137,190,340,high-risk
56542,12,175,297,484,high-risk
56543,12,191,219,422,high-risk
56551,12,75,109,196,medium-low-risk
56554,0,0,0,0,low-risk
56576,0,0,0,0,low-risk
56592,15,91,137,243,medium-low-risk
56596,12,90,168,270,medium-high-risk
56597,29,105,171,305,medium-high-risk
56599,17,80,102,199,medium-low-risk
56610,0,0,0,0,low-risk
5663,0,0,0,0,low-risk
56636,25,141,159,325,medium-high-risk
56637,0,0,0,0,low-risk
56646,12,90,125,227,medium-low-risk
56650,0,0,0,0,low-risk
56656,0,0,0,0,low-risk
56673,0,0,0,0,low-risk
56674,0,0,0,0,low-risk
56678,0,0,0,0,low-risk
56683,0,0,0,0,low-risk
56688,30,173,227,430,high-risk
56692,0,0,0,0,low-risk
56693,0,0,0,0,low-risk
56704,12,113,222,347,high-risk
56707,13,176,226,415,high-risk
56709,0,0,0,0,low-risk
5671,30,115,158,303,medium-high-risk
56715,0,0,0,0,low-risk
56725,0,0,0,0,low-risk
56726,19,148,181,348,high-risk
56727,0,0,0,0,low-risk
56730,0,0,0,0,low-risk
56733,0,0,0,0,low-risk
56737,0,0,0,0,low-risk
56741,0,0,0,0,low-risk
56743,0,0,0,0,low-risk
56747,0,0,0,0,low-risk
56748,15,156,221,392,high-risk
56770,0,0,0,0,low-risk
56786,0,0,0,0,low-risk
5679,14,162,189,365,high-risk
56800,0,0,0,0,low-risk
56805,0,0,0,0,low-risk
56814,20,113,178,311,medium-high-risk
56819,12,98,122,232,medium-low-risk
56826,12,122,209,343,high-risk
56828,33,107,169,309,medium-high-risk
56843,0,0,0,0,low-risk
56849,12,115,141,268,medium-high-risk
5685,0,0,0,0,low-risk
56851,26,154,213,393,high-risk
56862,0,0,0,0,low-risk
56873,0,0,0,0,low-risk
56882,12,120,163,295,medium-high-risk
56896,12,112,208,332,high-risk
56907,12,107,122,241,medium-low-risk
56920,14,148,219,381,high-risk
56932,13,81,98,192,medium-low-risk
56961,12,118,153,283,medium-high-risk
56963,0,0,0,0,low-risk
56966,0,0,0,0,low-risk
56976,22,68,139,229,medium-low-risk
56977,0,0,0,0,low-risk
56979,18,94,153,265,medium-high-risk
56983,12,93,148,253,medium-high-risk
56990,12,83,131,226,medium-low-risk
57006,0,0,0,0,low-risk
57007,0,0,0,0,low-risk
57008,0,0,0,0,low-risk
5701,27,122,180,329,medium-high-risk
57015,24,171,201,396,high-risk
57027,0,0,0,0,low-risk
57033,0,0,0,0,low-risk
57038,0,0,0,0,low-risk
57045,17,130,221,368,high-risk
57047,15,94,130,239,medium-low-risk
57048,0,0,0,0,low-risk
57049,0,0,0,0,low-risk
57059,12,200,142,354,high-risk
5706,12,141,180,333,high-risk
57064,16,87,174,277,medium-high-risk
57069,12,109,131,252,medium-high-risk
57070,12,127,178,317,medium-high-risk
57078,38,127,174,339,high-risk
57079,12,126,167,305,medium-high-risk
57080,27,177,210,414,high-risk
57088,0,0,0,0,low-risk
57095,0,0,0,0,low-risk
57098,12,121,153,286,medium-high-risk
57103,20,102,141,263,medium-high-risk
57137,37,126,164,327,medium-high-risk
57144,0,0,0,0,low-risk
57161,20,99,162,281,medium-high-risk
57170,0,0,0,0,low-risk
57171,12,178,195,385,high-risk
57194,0,0,0,0,low-risk
57199,0,0,0,0,low-risk
5720,24,117,190,331,high-risk
57204,14,113,216,343,high-risk
5721,0,0,0,0,low-risk
57213,12,141,174,327,medium-high-risk
57215,0,0,0,0,low-risk
57219,16,78,105,199,medium-low-risk
57225,22,129,261,412,high-risk
57229,0,0,0,0,low-risk
57235,18,63,103,184,medium-low-risk
57237,12,105,133,250,medium-high-risk
57254,0,0,0,0,low-risk
57276,18,88,134,240,medium-low-risk
57277,0,0,0,0,low-risk
57278,0,0,0,0,low-risk
5728,0,0,0,0,low-risk
57286,0,0,0,0,low-risk
57287,0,0,0,0,low-risk
57288,0,0,0,0,low-risk
57304,0,0,0,0,low-risk
57313,12,157,186,355,high-risk
57317,21,97,158,276,medium-high-risk
5733,11,146,174,331,high-risk
57345,0,0,0,0,low-risk
5736,0,0,0,0,low-risk
57365,12,122,155,289,medium-high-risk
57372,18,162,199,379,high-risk
57379,12,134,183,329,medium-high-risk
57381,0,0,0,0,low-risk
57389,13,127,175,315,medium-high-risk
57395,0,0,0,0,low-risk
5740,12,158,192,362,high-risk
57400,12,136,148,296,medium-high-risk
57404,12,116,149,277,medium-high-risk
57408,0,0,0,0,low-risk
57413,0,0,0,0,low-risk
57414,12,107,113,232,medium-low-risk
57419,0,0,0,0,low-risk
57425,12,145,270,427,high-risk
57429,12,73,70,155,medium-low-risk
57433,32,131,170,333,high-risk
57436,12,96,73,181,medium-low-risk
57445,0,0,0,0,low-risk
57447,0,0,0,0,low-risk
57450,18,109,151,278,medium-high-risk
57460,0,0,0,0,low-risk
57466,0,0,0,0,low-risk
57468,12,117,220,349,high-risk
57473,12,121,143,276,medium-high-risk
57509,0,0,0,0,low-risk
57536,0,0,0,0,low-risk
57538,0,0,0,0,low-risk
57542,0,0,0,0,low-risk
57549,31,170,234,435,high-risk
5755,0,0,0,0,low-risk
57562,0,0,0,0,low-risk
57564,16,103,146,265,medium-high-risk
57565,0,0,0,0,low-risk
57569,12,175,213,400,high-risk
57582,0,0,0,0,low-risk
57584,0,0,0,0,low-risk
57594,0,0,0,0,low-risk
57599,0,0,0,0,low-risk
57609,31,181,236,448,high-risk
57616,0,0,0,0,low-risk
57622,21,177,219,417,high-risk
57624,12,127,155,294,medium-high-risk
57631,0,0,0,0,low-risk
57633,0,0,0,0,low-risk
57639,12,104,185,301,medium-high-risk
57645,16,171,240,427,high-risk
57652,0,0,0,0,low-risk
57655,12,153,267,432,high-risk
57657,12,134,168,314,medium-high-risk
57662,12,124,182,318,medium-high-risk
57668,12,125,237,374,high-risk
57672,12,106,134,252,medium-high-risk
57673,0,0,0,0,low-risk
5768,0,0,0,0,low-risk
57690,16,95,145,256,medium-high-risk
57717,12,149,241,402,high-risk
57720,0,0,0,0,low-risk
57726,0,0,0,0,low-risk
57731,20,120,174,314,medium-high-risk
57736,12,143,179,334,high-risk
57740,12,139,192,343,high-risk
57745,28,117,172,317,medium-high-risk
5776,0,0,0,0,low-risk
57764,0,0,0,0,low-risk
57766,12,169,203,384,high-risk
57772,21,74,130,225,medium-low-risk
57778,12,148,206,366,high-risk
57781,0,0,0,0,low-risk
57796,0,0,0,0,low-risk
57799,40,145,215,400,high-risk
5782,13,167,143,323,medium-high-risk
57828,34,123,151,308,medium-high-risk
57839,0,0,0,0,low-risk
5784,12,119,146,277,medium-high-risk
57850,17,222,185,424,high-risk
57854,0,0,0,0,low-risk
57867,0,0,0,0,low-risk
57872,0,0,0,0,low-risk
57878,0,0,0,0,low-risk
57879,0,0,0,0,low-risk
57888,29,111,143,283,medium-high-risk
57893,33,160,219,412,high-risk
57904,0,0,0,0,low-risk
57919,17,132,195,344,high-risk
57936,0,0,0,0,low-risk
57942,12,83,109,204,medium-low-risk
57943,0,0,0,0,low-risk
57949,13,145,191,349,high-risk
57950,15,185,149,349,high-risk
5796,0,0,0,0,low-risk
57964,22,135,199,356,high-risk
5797,12,157,176,345,high-risk
57980,0,0,0,0,low-risk
57987,22,112,162,296,medium-high-risk
57990,0,0,0,0,low-risk
57993,51,145,201,397,high-risk
57995,12,120,151,283,medium-high-risk
58008,27,145,200,372,high-risk
58022,25,133,176,334,high-risk
5803,14,149,197,360,high-risk
58032,13,106,178,297,medium-high-risk
5805,56,128,165,349,high-risk
58055,0,0,0,0,low-risk
58056,0,0,0,0,low-risk
58074,0,0,0,0,low-risk
58075,0,0,0,0,low-risk
58076,19,92,148,259,medium-high-risk
58078,12,145,164,321,medium-high-risk
58079,0,0,0,0,low-risk
58086,20,98,150,268,medium-high-risk
5809,24,120,175,319,medium-high-risk
58104,12,80,121,213,medium-low-risk
58105,33,134,219,386,high-risk
58106,0,0,0,0,low-risk
58108,24,116,187,327,medium-high-risk
58115,24,154,258,436,high-risk
58122,12,73,110,195,medium-low-risk
58140,0,0,0,0,low-risk
58141,38,99,205,342,high-risk
58144,14,83,157,254,medium-high-risk
58145,0,0,0,0,low-risk
58147,12,87,108,207,medium-low-risk
58150,14,72,138,224,medium-low-risk
58153,0,0,0,0,low-risk
58160,12,106,128,246,medium-high-risk
58168,12,122,186,320,medium-high-risk
58170,12,142,172,326,medium-high-risk
58171,0,0,0,0,low-risk
58174,0,0,0,0,low-risk
58176,0,0,0,0,low-risk
58178,12,99,136,247,medium-high-risk
5819,0,0,0,0,low-risk
58190,0,0,0,0,low-risk
58191,0,0,0,0,low-risk
58199,0,0,0,0,low-risk
58200,12,103,151,266,medium-high-risk
58221,0,0,0,0,low-risk
58223,25,138,204,367,high-risk
5823,0,0,0,0,low-risk
58237,0,0,0,0,low-risk
58247,0,0,0,0,low-risk
58255,0,0,0,0,low-risk
58269,12,122,60,194,medium-low-risk
5828,0,0,0,0,low-risk
58282,0,0,0,0,low-risk
58292,0,0,0,0,low-risk
5831,11,124,148,283,medium-high-risk
58317,20,187,265,472,high-risk
58318,0,0,0,0,low-risk
5832,0,0,0,0,low-risk
58321,0,0,0,0,low-risk
58322,20,174,213,407,high-risk
58327,0,0,0,0,low-risk
58339,0,0,0,0,low-risk
5834,0,0,0,0,low-risk
58346,16,94,141,251,medium-high-risk
58351,12,127,157,296,medium-high-risk
58353,0,0,0,0,low-risk
58354,11,60,182,253,medium-high-risk
58356,0,0,0,0,low-risk
58372,12,135,160,307,medium-high-risk
58393,0,0,0,0,low-risk
58396,0,0,0,0,low-risk
58398,12,165,263,440,high-risk
58400,54,179,286,519,high-risk
58403,0,0,0,0,low-risk
58404,0,0,0,0,low-risk
58427,12,134,174,320,medium-high-risk
58428,41,173,460,674,high-risk
58439,14,122,191,327,medium-high-risk
5844,12,138,219,369,high-risk
58441,0,0,0,0,low-risk
58449,0,0,0,0,low-risk
58450,12,137,181,330,high-risk
58473,0,0,0,0,low-risk
58476,0,0,0,0,low-risk
58478,0,0,0,0,low-risk
58479,12,127,154,293,medium-high-risk
58481,12,76,190,278,medium-high-risk
58482,0,0,0,0,low-risk
58491,0,0,0,0,low-risk
58512,0,0,0,0,low-risk
58517,12,116,95,223,medium-low-risk
5852,14,187,229,430,high-risk
58522,0,0,0,0,low-risk
58523,12,107,140,259,medium-high-risk
5853,24,132,170,326,medium-high-risk
58530,0,0,0,0,low-risk
58531,12,141,151,304,medium-high-risk
58557,13,104,142,259,medium-high-risk
58564,0,0,0,0,low-risk
58571,18,110,156,284,medium-high-risk
58575,0,0,0,0,low-risk
58590,0,0,0,0,low-risk
58592,12,99,111,222,medium-low-risk
58593,0,0,0,0,low-risk
58594,0,0,0,0,low-risk
58611,12,160,207,379,high-risk
58622,0,0,0,0,low-risk
58626,17,123,148,288,medium-high-risk
58637,0,0,0,0,low-risk
58641,0,0,0,0,low-risk
58646,0,0,0,0,low-risk
58652,36,119,282,437,high-risk
58660,0,0,0,0,low-risk
58665,15,122,148,285,medium-high-risk
58676,20,157,207,384,high-risk
58678,0,0,0,0,low-risk
58688,0,0,0,0,low-risk
58689,19,128,172,319,medium-high-risk
58691,0,0,0,0,low-risk
58697,12,150,214,376,high-risk
58701,12,139,148,299,medium-high-risk
58728,0,0,0,0,low-risk
58731,18,84,122,224,medium-low-risk
5876,12,150,186,348,high-risk
58762,0,0,0,0,low-risk
58769,0,0,0,0,low-risk
58783,0,0,0,0,low-risk
58798,12,120,138,270,medium-high-risk
58808,0,0,0,0,low-risk
58813,20,182,232,434,high-risk
58815,31,125,165,321,medium-high-risk
58819,0,0,0,0,low-risk
5882,12,122,217,351,high-risk
58844,0,0,0,0,low-risk
58846,0,0,0,0,low-risk
58866,0,0,0,0,low-risk
58870,12,110,140,262,medium-high-risk
58871,0,0,0,0,low-risk
58875,0,0,0,0,low-risk
58881,34,119,155,308,medium-high-risk
5889,15,104,158,277,medium-high-risk
58890,12,135,219,366,high-risk
58891,0,0,0,0,low-risk
58898,13,150,291,454,high-risk
5890,15,92,124,231,medium-low-risk
58904,14,99,136,249,medium-high-risk
58910,12,121,218,351,high-risk
58920,0,0,0,0,low-risk
58922,42,147,438,627,high-risk
5893,0,0,0,0,low-risk
58933,14,169,195,378,high-risk
58959,15,146,296,457,high-risk
5896,0,0,0,0,low-risk
58961,47,132,185,364,high-risk
58966,0,0,0,0,low-risk
58967,12,88,118,218,medium-low-risk
58968,0,0,0,0,low-risk
58969,17,139,209,365,high-risk
58977,12,178,204,394,high-risk
58991,0,0,0,0,low-risk
59000,12,83,104,199,medium-low-risk
59001,12,125,143,280,medium-high-risk
59005,12,149,188,349,high-risk
59006,0,0,0,0,low-risk
59024,25,99,159,283,medium-high-risk
59036,14,98,138,250,medium-high-risk
59042,23,119,163,305,medium-high-risk
59047,11,161,221,393,high-risk
59055,35,137,211,383,high-risk
59063,0,0,0,0,low-risk
59067,12,96,109,217,medium-low-risk
59081,12,136,153,301,medium-high-risk
59092,19,148,222,389,high-risk
59100,12,119,153,284,medium-high-risk
59103,12,143,178,333,high-risk
59114,0,0,0,0,low-risk
59131,12,139,171,322,medium-high-risk
59147,0,0,0,0,low-risk
59151,47,118,309,474,high-risk
59155,17,135,197,349,high-risk
59156,12,118,134,264,medium-high-risk
59157,0,0,0,0,low-risk
59180,50,134,178,362,high-risk
59183,12,117,146,275,medium-high-risk
59188,0,0,0,0,low-risk
5919,12,102,111,225,medium-low-risk
59191,0,0,0,0,low-risk
59195,0,0,0,0,low-risk
59207,12,122,219,353,high-risk
59219,0,0,0,0,low-risk
59228,14,101,180,295,medium-high-risk
59232,0,0,0,0,low-risk
59238,0,0,0,0,low-risk
59239,12,118,141,271,medium-high-risk
59247,13,89,145,247,medium-high-risk
59255,16,121,249,386,high-risk
59256,37,106,156,299,medium-high-risk
59260,0,0,0,0,low-risk
59261,0,0,0,0,low-risk
59273,0,0,0,0,low-risk
59284,0,0,0,0,low-risk
59293,0,0,0,0,low-risk
59294,12,144,226,382,high-risk
59298,13,118,190,321,medium-high-risk
59300,28,118,188,334,high-risk
59305,0,0,0,0,low-risk
59307,0,0,0,0,low-risk
59309,0,0,0,0,low-risk
59313,0,0,0,0,low-risk
59317,12,144,290,446,high-risk
59318,12,148,188,348,high-risk
59320,12,146,175,333,high-risk
59352,12,158,171,341,high-risk
59356,12,115,145,272,medium-high-risk
5936,12,143,171,326,medium-high-risk
59362,0,0,0,0,low-risk
59370,13,166,240,419,high-risk
59374,15,43,200,258,medium-high-risk
59376,12,94,113,219,medium-low-risk
59385,0,0,0,0,low-risk
59389,25,130,209,364,high-risk
59394,20,138,195,353,high-risk
59404,0,0,0,0,low-risk
5941,45,97,251,393,high-risk
59410,23,108,175,306,medium-high-risk
59429,14,96,148,258,medium-high-risk
59433,0,0,0,0,low-risk
59436,16,102,154,272,medium-high-risk
59439,0,0,0,0,low-risk
59442,0,0,0,0,low-risk
59444,36,173,191,400,high-risk
59458,21,85,139,245,medium-high-risk
59479,26,89,119,234,medium-low-risk
59499,0,0,0,0,low-risk
59500,0,0,0,0,low-risk
59507,0,0,0,0,low-risk
59511,12,106,142,260,medium-high-risk
59533,21,130,175,326,medium-high-risk
59539,12,165,221,398,high-risk
59544,12,149,169,330,high-risk
59553,41,142,304,487,high-risk
59554,12,113,215,340,high-risk
59555,32,132,193,357,high-risk
59565,0,0,0,0,low-risk
59572,0,0,0,0,low-risk
59579,40,137,179,356,high-risk
59583,12,146,185,343,high-risk
59593,21,79,268,368,high-risk
59595,0,0,0,0,low-risk
5960,14,139,181,334,high-risk
59605,23,94,137,254,medium-high-risk
59606,25,97,151,273,medium-high-risk
59609,12,188,219,419,high-risk
59631,12,93,130,235,medium-low-risk
59639,17,110,172,299,medium-high-risk
59640,0,0,0,0,low-risk
59641,0,0,0,0,low-risk
59649,0,0,0,0,low-risk
59654,11,144,181,336,high-risk
59664,0,0,0,0,low-risk
5967,0,0,0,0,low-risk
59678,12,85,177,274,medium-high-risk
59680,12,88,100,200,medium-low-risk
59697,12,100,139,251,medium-high-risk
59704,12,187,214,413,high-risk
59708,0,0,0,0,low-risk
59712,14,167,239,420,high-risk
59733,0,0,0,0,low-risk
5976,0,0,0,0,low-risk
59765,13,122,206,341,high-risk
59771,0,0,0,0,low-risk
59775,18,154,212,384,high-risk
59776,0,0,0,0,low-risk
59777,17,168,217,402,high-risk
59778,0,0,0,0,low-risk
5979,12,149,166,327,medium-high-risk
59791,11,121,164,296,medium-high-risk
59803,12,116,166,294,medium-high-risk
59810,17,106,153,276,medium-high-risk
59816,25,119,170,314,medium-high-risk
59817,0,0,0,0,low-risk
59828,27,166,306,499,high-risk
59834,12,150,163,325,medium-high-risk
59835,33,152,214,399,high-risk
5984,34,203,265,502,high-risk
59846,15,118,165,298,medium-high-risk
59847,41,155,243,439,high-risk
59853,0,0,0,0,low-risk
59864,12,154,201,367,high-risk
59872,0,0,0,0,low-risk
59873,12,242,264,518,high-risk
59874,12,128,183,323,medium-high-risk
59886,12,124,140,276,medium-high-risk
59887,12,222,158,392,high-risk
59889,12,114,165,291,medium-high-risk
59899,13,154,232,399,high-risk
59900,0,0,0,0,low-risk
59905,13,204,328,545,high-risk
59914,0,0,0,0,low-risk
59923,13,126,161,300,medium-high-risk
59925,29,147,199,375,high-risk
59926,12,139,145,296,medium-high-risk
59943,12,121,164,297,medium-high-risk
59950,12,103,145,260,medium-high-risk
59959,12,155,203,370,high-risk
59969,12,90,122,224,medium-low-risk
59973,12,102,121,235,medium-low-risk
59992,0,0,0,0,low-risk
59998,13,127,194,334,high-risk
60008,12,90,151,253,medium-high-risk
60023,0,0,0,0,low-risk
60041,0,0,0,0,low-risk
60048,0,0,0,0,low-risk
60050,0,0,0,0,low-risk
60056,31,160,194,385,high-risk
60061,0,0,0,0,low-risk
60075,16,102,238,356,high-risk
60077,0,0,0,0,low-risk
60079,26,147,276,449,high-risk
60086,14,125,157,296,medium-high-risk
60089,0,0,0,0,low-risk
60091,0,0,0,0,low-risk
60097,13,113,243,369,high-risk
6010,18,144,283,445,high-risk
60126,15,164,218,397,high-risk
60137,12,82,112,206,medium-low-risk
60145,17,77,127,221,medium-low-risk
60158,0,0,0,0,low-risk
6016,34,117,162,313,medium-high-risk
60160,23,96,159,278,medium-high-risk
60164,0,0,0,0,low-risk
60186,35,157,210,402,high-risk
60187,0,0,0,0,low-risk
60188,22,78,181,281,medium-high-risk
6019,0,0,0,0,low-risk
60197,12,149,189,350,high-risk
60203,0,0,0,0,low-risk
60222,0,0,0,0,low-risk
60223,12,100,132,244,medium-low-risk
60229,0,0,0,0,low-risk
60237,12,98,129,239,medium-low-risk
60242,14,113,162,289,medium-high-risk
60258,0,0,0,0,low-risk
60260,12,86,90,188,medium-low-risk
60261,20,121,183,324,medium-high-risk
60262,12,118,165,295,medium-high-risk
60263,0,0,0,0,low-risk
60269,0,0,0,0,low-risk
60284,18,119,146,283,medium-high-risk
60293,0,0,0,0,low-risk
60295,12,144,164,320,medium-high-risk
6030,12,132,161,305,medium-high-risk
60300,0,0,0,0,low-risk
60303,0,0,0,0,low-risk
60308,34,100,122,256,medium-high-risk
6031,19,157,206,382,high-risk
60313,33,158,199,390,high-risk
60315,0,0,0,0,low-risk
60323,0,0,0,0,low-risk
60326,19,114,137,270,medium-high-risk
60330,12,264,202,478,high-risk
60338,0,0,0,0,low-risk
60339,15,155,187,357,high-risk
60341,12,142,189,343,high-risk
60345,14,181,209,404,high-risk
60359,0,0,0,0,low-risk
60365,12,119,153,284,medium-high-risk
60371,13,100,139,252,medium-high-risk
60373,12,136,201,349,high-risk
60375,0,0,0,0,low-risk
60376,21,132,165,318,medium-high-risk
60390,0,0,0,0,low-risk
60395,0,0,0,0,low-risk
60402,12,141,162,315,medium-high-risk
60416,27,117,132,276,medium-high-risk
60419,12,86,109,207,medium-low-risk
60422,0,0,0,0,low-risk
60423,0,0,0,0,low-risk
60424,12,140,239,391,high-risk
60443,0,0,0,0,low-risk
60445,0,0,0,0,low-risk
60452,11,144,176,331,high-risk
6046,13,151,208,372,high-risk
60465,0,0,0,0,low-risk
60475,12,127,176,315,medium-high-risk
60476,12,143,182,337,high-risk
6048,12,111,126,249,medium-high-risk
60480,0,0,0,0,low-risk
60485,46,114,294,454,high-risk
60489,0,0,0,0,low-risk
60504,31,142,175,348,high-risk
6051,0,0,0,0,low-risk
60511,0,0,0,0,low-risk
60525,12,153,215,380,high-risk
6053,22,109,137,268,medium-high-risk
60530,0,0,0,0,low-risk
60534,0,0,0,0,low-risk
60535,12,135,163,310,medium-high-risk
60549,0,0,0,0,low-risk
60554,13,124,166,303,medium-high-risk
60555,20,124,185,329,medium-high-risk
60558,38,142,193,373,high-risk
60561,0,0,0,0,low-risk
60562,0,0,0,0,low-risk
60565,14,122,218,354,high-risk
60576,0,0,0,0,low-risk
6058,13,151,288,452,high-risk
6059,28,103,132,263,medium-high-risk
60590,0,0,0,0,low-risk
60597,12,126,160,298,medium-high-risk
6060,12,126,192,330,high-risk
60631,12,82,126,220,medium-low-risk
60657,0,0,0,0,low-risk
60666,26,112,179,317,medium-high-risk
60668,15,100,201,316,medium-high-risk
60672,28,143,177,348,high-risk
60673,0,0,0,0,low-risk
60674,12,175,229,416,high-risk
60678,12,129,161,302,medium-high-risk
6069,0,0,0,0,low-risk
60695,12,112,143,267,medium-high-risk
60703,0,0,0,0,low-risk
60709,15,122,177,314,medium-high-risk
60712,31,107,162,300,medium-high-risk
60749,38,130,233,401,high-risk
60765,14,120,153,287,medium-high-risk
60779,0,0,0,0,low-risk
60780,12,152,194,358,high-risk
60785,17,117,154,288,medium-high-risk
60793,0,0,0,0,low-risk
60797,0,0,0,0,low-risk
60816,42,129,190,361,high-risk
6082,0,0,0,0,low-risk
60820,0,0,0,0,low-risk
60826,0,0,0,0,low-risk
60830,0,0,0,0,low-risk
60841,12,130,150,292,medium-high-risk
60846,12,129,190,331,high-risk
6085,0,0,0,0,low-risk
60852,37,119,199,355,high-risk
60859,12,146,168,326,medium-high-risk
60869,0,0,0,0,low-risk
60871,15,106,175,296,medium-high-risk
60878,0,0,0,0,low-risk
60882,14,114,141,269,medium-high-risk
60888,26,194,262,482,high-risk
60891,21,172,236,429,high-risk
60910,12,92,131,235,medium-low-risk
60912,12,154,232,398,high-risk
60919,12,97,173,282,medium-high-risk
60925,16,133,165,314,medium-high-risk
60930,0,0,0,0,low-risk
6094,13,129,215,357,high-risk
60940,0,0,0,0,low-risk
60957,0,0,0,0,low-risk
60959,18,182,233,433,high-risk
60960,12,155,189,356,high-risk
60964,12,135,159,306,medium-high-risk
60968,0,0,0,0,low-risk
6097,12,152,181,345,high-risk
60971,13,106,146,265,medium-high-risk
60982,0,0,0,0,low-risk
6100,12,120,143,275,medium-high-risk
61001,12,115,188,315,medium-high-risk
61005,12,147,175,334,high-risk
61016,0,0,0,0,low-risk
61022,0,0,0,0,low-risk
61024,33,149,203,385,high-risk
61026,0,0,0,0,low-risk
61030,0,0,0,0,low-risk
61037,0,0,0,0,low-risk
6104,19,97,188,304,medium-high-risk
61041,42,183,375,600,high-risk
61061,0,0,0,0,low-risk
6107,12,105,155,272,medium-high-risk
61078,0,0,0,0,low-risk
61083,12,138,193,343,high-risk
61086,12,140,222,374,high-risk
61098,28,85,210,323,medium-high-risk
61104,0,0,0,0,low-risk
61106,11,192,129,332,high-risk
61108,0,0,0,0,low-risk
61113,0,0,0,0,low-risk
61116,0,0,0,0,low-risk
61118,0,0,0,0,low-risk
61127,12,144,162,318,medium-high-risk
61128,13,97,132,242,medium-low-risk
61144,0,0,0,0,low-risk
61150,25,125,193,343,high-risk
61152,12,104,130,246,medium-high-risk
61158,12,130,170,312,medium-high-risk
61165,12,122,137,271,medium-high-risk
61166,12,107,123,242,medium-low-risk
61174,0,0,0,0,low-risk
61184,17,140,188,345,high-risk
61195,15,155,200,370,high-risk
61196,0,0,0,0,low-risk
61215,35,146,189,370,high-risk
61217,0,0,0,0,low-risk
61219,43,181,365,589,high-risk
61220,0,0,0,0,low-risk
61222,12,108,129,249,medium-high-risk
61225,31,127,166,324,medium-high-risk
61244,0,0,0,0,low-risk
61250,12,153,171,336,high-risk
61275,12,138,160,310,medium-high-risk
61276,0,0,0,0,low-risk
61277,0,0,0,0,low-risk
61284,0,0,0,0,low-risk
6130,0,0,0,0,low-risk
61307,12,90,109,211,medium-low-risk
61320,14,154,184,352,high-risk
61321,0,0,0,0,low-risk
61338,0,0,0,0,low-risk
61341,12,109,150,271,medium-high-risk
61344,12,106,137,255,medium-high-risk
61350,0,0,0,0,low-risk
61365,0,0,0,0,low-risk
61382,0,0,0,0,low-risk
61383,0,0,0,0,low-risk
61389,12,138,169,319,medium-high-risk
61409,17,160,230,407,high-risk
61411,13,154,276,443,high-risk
61421,0,0,0,0,low-risk
61422,12,195,242,449,high-risk
61447,0,0,0,0,low-risk
61457,0,0,0,0,low-risk
61459,12,101,133,246,medium-high-risk
61463,20,94,138,252,medium-high-risk
61464,13,112,205,330,high-risk
61467,22,142,196,360,high-risk
61472,0,0,0,0,low-risk
61475,0,0,0,0,low-risk
61484,37,95,261,393,high-risk
61486,0,0,0,0,low-risk
61487,0,0,0,0,low-risk
61497,12,145,222,379,high-risk
61504,0,0,0,0,low-risk
61506,12,137,175,324,medium-high-risk
61507,0,0,0,0,low-risk
6151,0,0,0,0,low-risk
61512,55,179,217,451,high-risk
61515,0,0,0,0,low-risk
61519,48,143,199,390,high-risk
61532,0,0,0,0,low-risk
61535,0,0,0,0,low-risk
61537,0,0,0,0,low-risk
6154,17,147,191,355,high-risk
61544,0,0,0,0,low-risk
61549,0,0,0,0,low-risk
61551,0,0,0,0,low-risk
61552,0,0,0,0,low-risk
61554,34,133,191,358,high-risk
61558,12,143,239,394,high-risk
61559,0,0,0,0,low-risk
61560,13,99,131,243,medium-low-risk
61572,11,109,125,245,medium-high-risk
61579,0,0,0,0,low-risk
61580,0,0,0,0,low-risk
61584,12,144,186,342,high-risk
61601,0,0,0,0,low-risk
61604,12,160,180,352,high-risk
61611,0,0,0,0,low-risk
61621,0,0,0,0,low-risk
61630,19,116,179,314,medium-high-risk
61643,12,87,124,223,medium-low-risk
61656,12,89,113,214,medium-low-risk
61665,0,0,0,0,low-risk
61666,12,98,110,220,medium-low-risk
61680,0,0,0,0,low-risk
61687,0,0,0,0,low-risk
61713,12,103,117,232,medium-low-risk
61720,0,0,0,0,low-risk
61727,0,0,0,0,low-risk
61744,12,144,174,330,high-risk
61751,31,118,392,541,high-risk
61752,0,0,0,0,low-risk
61755,0,0,0,0,low-risk
61756,12,119,197,328,medium-high-risk
61764,27,136,195,358,high-risk
61767,12,123,145,280,medium-high-risk
61772,0,0,0,0,low-risk
61802,13,133,176,322,medium-high-risk
61805,23,124,213,360,high-risk
61806,0,0,0,0,low-risk
61816,18,173,226,417,high-risk
61819,14,147,218,379,high-risk
61832,12,159,126,297,medium-high-risk
6186,19,101,141,261,medium-high-risk
61869,29,134,162,325,medium-high-risk
61871,12,141,165,318,medium-high-risk
61872,44,118,199,361,high-risk
61889,0,0,0,0,low-risk
61897,12,80,106,198,medium-low-risk
61916,0,0,0,0,low-risk
61922,12,91,127,230,medium-low-risk
61923,0,0,0,0,low-risk
61935,0,0,0,0,low-risk
6194,12,106,150,268,medium-high-risk
61950,22,97,180,299,medium-high-risk
61957,27,129,184,340,high-risk
61958,0,0,0,0,low-risk
61975,0,0,0,0,low-risk
61981,12,138,191,341,high-risk
61983,22,111,159,292,medium-high-risk
61985,46,138,238,422,high-risk
61987,0,0,0,0,low-risk
61997,32,135,174,341,high-risk
61998,27,202,261,490,high-risk
62005,20,206,361,587,high-risk
62013,0,0,0,0,low-risk
62014,14,119,187,320,medium-high-risk
62021,12,117,175,304,medium-high-risk
62031,0,0,0,0,low-risk
62036,12,128,162,302,medium-high-risk
62041,45,134,217,396,high-risk
62043,0,0,0,0,low-risk
62047,12,105,146,263,medium-high-risk
62049,22,131,191,344,high-risk
62053,14,194,150,358,high-risk
62054,0,0,0,0,low-risk
62056,0,0,0,0,low-risk
62059,0,0,0,0,low-risk
62065,15,115,163,293,medium-high-risk
62069,22,121,179,322,medium-high-risk
62070,0,0,0,0,low-risk
62073,12,109,140,261,medium-high-risk
62077,0,0,0,0,low-risk
62078,12,81,126,219,medium-low-risk
6208,0,0,0,0,low-risk
62083,37,119,155,311,medium-high-risk
62085,0,0,0,0,low-risk
62086,0,0,0,0,low-risk
62093,12,153,238,403,high-risk
62099,12,135,249,396,high-risk
62105,13,166,220,399,high-risk
62106,28,153,222,403,high-risk
6211,24,113,168,305,medium-high-risk
62116,12,112,162,286,medium-high-risk
62122,12,151,159,322,medium-high-risk
62124,12,91,120,223,medium-low-risk
62126,0,0,0,0,low-risk
62129,0,0,0,0,low-risk
62131,14,127,200,341,high-risk
62139,0,0,0,0,low-risk
62161,0,0,0,0,low-risk
62164,0,0,0,0,low-risk
62166,0,0,0,0,low-risk
62179,0,0,0,0,low-risk
62183,12,103,134,249,medium-high-risk
62188,0,0,0,0,low-risk
62190,0,0,0,0,low-risk
62195,0,0,0,0,low-risk
62207,0,0,0,0,low-risk
62213,12,93,111,216,medium-low-risk
62214,12,106,124,242,medium-low-risk
62217,28,160,204,392,high-risk
62225,0,0,0,0,low-risk
62232,12,98,138,248,medium-high-risk
62234,0,0,0,0,low-risk
62242,18,155,240,413,high-risk
62243,40,173,231,444,high-risk
6226,0,0,0,0,low-risk
62262,0,0,0,0,low-risk
62274,22,128,153,303,medium-high-risk
62286,0,0,0,0,low-risk
62287,0,0,0,0,low-risk
62292,0,0,0,0,low-risk
62295,0,0,0,0,low-risk
62299,0,0,0,0,low-risk
62315,0,0,0,0,low-risk
62322,37,132,208,377,high-risk
62328,12,92,111,215,medium-low-risk
6233,14,147,248,409,high-risk
62338,13,130,163,306,medium-high-risk
6234,12,127,150,289,medium-high-risk
62352,0,0,0,0,low-risk
62353,0,0,0,0,low-risk
62371,25,157,216,398,high-risk
62377,12,140,150,302,medium-high-risk
62378,0,0,0,0,low-risk
62384,14,124,161,299,medium-high-risk
62387,13,120,273,406,high-risk
62392,0,0,0,0,low-risk
62396,26,115,240,381,high-risk
62401,15,108,159,282,medium-high-risk
62406,12,172,205,389,high-risk
62407,12,162,185,359,high-risk
62409,0,0,0,0,low-risk
62412,0,0,0,0,low-risk
62413,0,0,0,0,low-risk
62416,0,0,0,0,low-risk
62417,12,126,167,305,medium-high-risk
62420,0,0,0,0,low-risk
62423,12,146,206,364,high-risk
62428,14,125,201,340,high-risk
62429,12,204,149,365,high-risk
62440,47,125,265,437,high-risk
62452,0,0,0,0,low-risk
62456,12,110,146,268,medium-high-risk
62457,14,131,192,337,high-risk
62458,12,113,219,344,high-risk
6246,12,77,118,207,medium-low-risk
62474,40,156,212,408,high-risk
62482,0,0,0,0,low-risk
62485,12,157,239,408,high-risk
62497,0,0,0,0,low-risk
62501,19,149,239,407,high-risk
62524,12,124,186,322,medium-high-risk
62533,0,0,0,0,low-risk
62541,12,128,191,331,high-risk
62547,0,0,0,0,low-risk
62562,13,195,244,452,high-risk
62567,25,103,186,314,medium-high-risk
62574,0,0,0,0,low-risk
62575,29,265,186,480,high-risk
62580,14,142,210,366,high-risk
62598,17,143,193,353,high-risk
62601,0,0,0,0,low-risk
62608,16,96,170,282,medium-high-risk
6261,0,0,0,0,low-risk
62613,12,118,159,289,medium-high-risk
62615,12,113,140,265,medium-high-risk
62617,12,133,196,341,high-risk
62619,0,0,0,0,low-risk
62623,0,0,0,0,low-risk
62626,0,0,0,0,low-risk
62631,0,0,0,0,low-risk
62635,39,142,208,389,high-risk
62639,12,145,162,319,medium-high-risk
62659,17,164,247,428,high-risk
62701,33,151,187,371,high-risk
62702,12,131,227,370,high-risk
62703,0,0,0,0,low-risk
62707,12,183,230,425,high-risk
62716,0,0,0,0,low-risk
62727,14,139,232,385,high-risk
62746,12,148,184,344,high-risk
62755,0,0,0,0,low-risk
62758,17,119,158,294,medium-high-risk
62765,12,134,168,314,medium-high-risk
62768,12,126,136,274,medium-high-risk
62771,12,110,151,273,medium-high-risk
62777,0,0,0,0,low-risk
62782,29,112,142,283,medium-high-risk
62785,0,0,0,0,low-risk
62786,11,118,145,274,medium-high-risk
62792,0,0,0,0,low-risk
62794,0,0,0,0,low-risk
62797,34,127,191,352,high-risk
6281,0,0,0,0,low-risk
62810,17,146,206,369,high-risk
6282,0,0,0,0,low-risk
62841,12,103,133,248,medium-high-risk
62842,14,210,360,584,high-risk
62843,0,0,0,0,low-risk
62854,0,0,0,0,low-risk
62856,0,0,0,0,low-risk
6286,12,106,163,281,medium-high-risk
62863,12,170,215,397,high-risk
62870,0,0,0,0,low-risk
62873,15,131,178,324,medium-high-risk
62876,12,153,166,331,high-risk
62884,12,116,136,264,medium-high-risk
62885,12,159,203,374,high-risk
62888,0,0,0,0,low-risk
6289,12,141,182,335,high-risk
62900,0,0,0,0,low-risk
62907,12,152,194,358,high-risk
62909,12,134,171,317,medium-high-risk
62913,0,0,0,0,low-risk
62916,0,0,0,0,low-risk
62917,12,91,137,240,medium-low-risk
62923,12,106,152,270,medium-high-risk
6293,15,96,123,234,medium-low-risk
62931,0,0,0,0,low-risk
62936,11,100,141,252,medium-high-risk
6295,12,90,141,243,medium-low-risk
6296,12,125,218,355,high-risk
62961,0,0,0,0,low-risk
62964,42,120,177,339,high-risk
62966,13,149,208,370,high-risk
62970,12,517,211,740,high-risk
62972,0,0,0,0,low-risk
62981,0,0,0,0,low-risk
62987,12,129,171,312,medium-high-risk
62989,11,111,137,259,medium-high-risk
62995,12,130,174,316,medium-high-risk
62998,12,175,236,423,high-risk
6302,13,134,237,384,high-risk
63025,0,0,0,0,low-risk
63039,0,0,0,0,low-risk
63041,0,0,0,0,low-risk
63045,12,161,184,357,high-risk
63048,12,136,173,321,medium-high-risk
63059,34,113,150,297,medium-high-risk
63060,12,120,155,287,medium-high-risk
63070,12,91,139,242,medium-low-risk
63083,12,151,217,380,high-risk
63087,0,0,0,0,low-risk
63110,15,111,130,256,medium-high-risk
63111,13,153,181,347,high-risk
63143,30,116,182,328,medium-high-risk
6315,13,131,217,361,high-risk
63150,13,142,176,331,high-risk
63157,12,118,194,324,medium-high-risk
63160,0,0,0,0,low-risk
63165,0,0,0,0,low-risk
63167,0,0,0,0,low-risk
63170,36,89,195,320,medium-high-risk
63172,0,0,0,0,low-risk
63175,0,0,0,0,low-risk
63177,22,120,169,311,medium-high-risk
63180,22,146,244,412,high-risk
63197,0,0,0,0,low-risk
63200,0,0,0,0,low-risk
63209,0,0,0,0,low-risk
6321,0,0,0,0,low-risk
63224,15,98,167,280,medium-high-risk
63232,12,114,125,251,medium-high-risk
6324,0,0,0,0,low-risk
63250,18,95,169,282,medium-high-risk
63253,0,0,0,0,low-risk
63256,14,96,138,248,medium-high-risk
63258,12,123,262,397,high-risk
6327,13,77,122,212,medium-low-risk
63273,12,146,199,357,high-risk
63279,0,0,0,0,low-risk
63284,12,126,194,332,high-risk
63290,0,0,0,0,low-risk
63292,12,113,167,292,medium-high-risk
63300,27,122,175,324,medium-high-risk
63329,0,0,0,0,low-risk
63335,12,86,112,210,medium-low-risk
63351,0,0,0,0,low-risk
63357,24,117,174,315,medium-high-risk
63370,0,0,0,0,low-risk
63374,12,114,140,266,medium-high-risk
63377,0,0,0,0,low-risk
63379,0,0,0,0,low-risk
63380,12,108,151,271,medium-high-risk
63382,0,0,0,0,low-risk
6339,12,141,195,348,high-risk
63390,21,92,137,250,medium-high-risk
63391,0,0,0,0,low-risk
63392,0,0,0,0,low-risk
63394,12,146,212,370,high-risk
63399,19,126,166,311,medium-high-risk
63401,0,0,0,0,low-risk
63404,0,0,0,0,low-risk
63408,13,125,182,320,medium-high-risk
63410,20,106,175,301,medium-high-risk
63422,11,160,176,347,high-risk
63430,12,136,152,300,medium-high-risk
63443,0,0,0,0,low-risk
63446,12,170,193,375,high-risk
63452,14,100,149,263,medium-high-risk
63463,0,0,0,0,low-risk
6347,15,107,165,287,medium-high-risk
63471,12,120,143,275,medium-high-risk
63478,28,104,151,283,medium-high-risk
63490,24,128,184,336,high-risk
63497,12,137,170,319,medium-high-risk
63501,16,86,118,220,medium-low-risk
63503,0,0,0,0,low-risk
63507,13,196,223,432,high-risk
63515,12,74,112,198,medium-low-risk
63527,17,150,195,362,high-risk
63529,12,81,105,198,medium-low-risk
63530,29,116,153,298,medium-high-risk
63548,19,110,162,291,medium-high-risk
6355,0,0,0,0,low-risk
63557,0,0,0,0,low-risk
63561,0,0,0,0,low-risk
63564,24,156,203,383,high-risk
63569,11,91,135,237,medium-low-risk
63574,25,108,146,279,medium-high-risk
63581,0,0,0,0,low-risk
63586,0,0,0,0,low-risk
63594,41,157,218,416,high-risk
6360,12,103,140,255,medium-high-risk
63601,0,0,0,0,low-risk
63605,11,141,163,315,medium-high-risk
6361,13,90,145,248,medium-high-risk
63610,38,149,194,381,high-risk
63614,12,118,144,274,medium-high-risk
63615,48,198,293,539,high-risk
6362,20,125,235,380,high-risk
63621,0,0,0,0,low-risk
63625,12,112,72,196,medium-low-risk
63629,34,149,180,363,high-risk
63653,0,0,0,0,low-risk
63654,34,109,158,301,medium-high-risk
63664,22,92,116,230,medium-low-risk
63665,12,130,172,314,medium-high-risk
63669,31,143,203,377,high-risk
63673,0,0,0,0,low-risk
63676,12,136,180,328,medium-high-risk
63681,0,0,0,0,low-risk
63705,30,124,296,450,high-risk
63709,0,0,0,0,low-risk
63715,12,129,205,346,high-risk
63721,12,166,223,401,high-risk
63734,0,0,0,0,low-risk
63738,12,125,154,291,medium-high-risk
63764,0,0,0,0,low-risk
63767,0,0,0,0,low-risk
63779,22,154,223,399,high-risk
63790,0,0,0,0,low-risk
63798,0,0,0,0,low-risk
63803,14,99,152,265,medium-high-risk
63812,12,120,154,286,medium-high-risk
6382,0,0,0,0,low-risk
63821,12,129,169,310,medium-high-risk
63838,0,0,0,0,low-risk
63844,0,0,0,0,low-risk
63848,0,0,0,0,low-risk
63849,12,139,171,322,medium-high-risk
63851,0,0,0,0,low-risk
63852,0,0,0,0,low-risk
63860,23,177,236,436,high-risk
63862,12,120,152,284,medium-high-risk
63865,12,158,185,355,high-risk
63867,27,144,200,371,high-risk
63890,12,149,100,261,medium-high-risk
63892,18,152,196,366,high-risk
63895,0,0,0,0,low-risk
63898,11,97,139,247,medium-high-risk
63909,12,147,187,346,high-risk
63918,14,175,218,407,high-risk
63923,0,0,0,0,low-risk
63924,13,144,207,364,high-risk
63927,20,74,121,215,medium-low-risk
63945,12,110,159,281,medium-high-risk
63960,0,0,0,0,low-risk
63967,12,142,170,324,medium-high-risk
6400,0,0,0,0,low-risk
64000,12,116,139,267,medium-high-risk
64008,30,162,208,400,high-risk
64011,0,0,0,0,low-risk
64016,0,0,0,0,low-risk
64037,0,0,0,0,low-risk
64056,19,93,170,282,medium-high-risk
6406,12,158,219,389,high-risk
64062,27,110,186,323,medium-high-risk
64064,20,161,287,468,high-risk
64076,0,0,0,0,low-risk
64091,0,0,0,0,low-risk
64092,0,0,0,0,low-risk
64093,0,0,0,0,low-risk
64096,12,113,163,288,medium-high-risk
64099,12,126,145,283,medium-high-risk
64100,54,137,184,375,high-risk
64101,34,132,181,347,high-risk
64111,41,130,198,369,high-risk
64123,25,151,223,399,high-risk
64130,0,0,0,0,low-risk
64147,12,157,204,373,high-risk
6415,12,109,226,347,high-risk
64159,0,0,0,0,low-risk
64176,39,145,212,396,high-risk
6418,0,0,0,0,low-risk
64181,32,109,153,294,medium-high-risk
64184,45,143,184,372,high-risk
64185,0,0,0,0,low-risk
64188,12,143,188,343,high-risk
64191,40,120,157,317,medium-high-risk
64192,12,143,179,334,high-risk
64196,0,0,0,0,low-risk
64198,12,63,83,158,medium-low-risk
64200,12,145,156,313,medium-high-risk
64207,30,99,168,297,medium-high-risk
64208,12,131,162,305,medium-high-risk
64210,12,105,171,288,medium-high-risk
64214,0,0,0,0,low-risk
64218,12,132,165,309,medium-high-risk
64225,12,105,142,259,medium-high-risk
64241,13,151,315,479,high-risk
64251,39,130,157,326,medium-high-risk
64253,0,0,0,0,low-risk
64264,0,0,0,0,low-risk
64268,12,111,136,259,medium-high-risk
64272,12,87,118,217,medium-low-risk
64288,0,0,0,0,low-risk
64291,28,108,142,278,medium-high-risk
64292,17,142,177,336,high-risk
64303,0,0,0,0,low-risk
64304,12,90,120,222,medium-low-risk
6431,18,90,141,249,medium-high-risk
64314,14,165,198,377,high-risk
64327,13,127,172,312,medium-high-risk
64333,0,0,0,0,low-risk
6434,0,0,0,0,low-risk
64354,12,126,218,356,high-risk
64357,13,91,130,234,medium-low-risk
64370,0,0,0,0,low-risk
64384,12,106,143,261,medium-high-risk
64397,20,98,136,254,medium-high-risk
64406,12,127,136,275,medium-high-risk
64411,12,154,240,406,high-risk
64421,0,0,0,0,low-risk
64445,0,0,0,0,low-risk
6445,21,109,153,283,medium-high-risk
64455,24,131,158,313,medium-high-risk
64466,0,0,0,0,low-risk
64472,12,125,145,282,medium-high-risk
64476,12,124,192,328,medium-high-risk
64487,0,0,0,0,low-risk
64501,0,0,0,0,low-risk
64503,0,0,0,0,low-risk
64509,37,114,148,299,medium-high-risk
64528,15,140,193,348,high-risk
64531,0,0,0,0,low-risk
64540,0,0,0,0,low-risk
64543,12,114,208,334,high-risk
64555,12,77,113,202,medium-low-risk
64559,43,226,184,453,high-risk
64573,12,73,81,166,medium-low-risk
64581,12,128,165,305,medium-high-risk
64582,0,0,0,0,low-risk
64583,12,120,148,280,medium-high-risk
6459,37,132,179,348,high-risk
64594,0,0,0,0,low-risk
64605,12,112,154,278,medium-high-risk
64608,31,131,177,339,high-risk
64612,0,0,0,0,low-risk
64619,12,139,218,369,high-risk
64627,12,106,152,270,medium-high-risk
64639,15,78,151,244,medium-low-risk
64640,0,0,0,0,low-risk
64653,12,90,120,222,medium-low-risk
64658,12,118,166,296,medium-high-risk
64660,0,0,0,0,low-risk
64671,31,119,181,331,high-risk
64679,37,123,173,333,high-risk
6468,27,118,159,304,medium-high-risk
64691,12,168,206,386,high-risk
64696,0,0,0,0,low-risk
64700,0,0,0,0,low-risk
64713,0,0,0,0,low-risk
64715,12,99,147,258,medium-high-risk
64720,0,0,0,0,low-risk
64722,37,125,146,308,medium-high-risk
64731,0,0,0,0,low-risk
64738,12,100,117,229,medium-low-risk
64760,0,0,0,0,low-risk
64761,12,94,122,228,medium-low-risk
64762,0,0,0,0,low-risk
64767,0,0,0,0,low-risk
64772,12,92,105,209,medium-low-risk
64774,21,86,132,239,medium-low-risk
64781,12,116,184,312,medium-high-risk
64785,0,0,0,0,low-risk
64792,0,0,0,0,low-risk
64796,0,0,0,0,low-risk
64800,12,127,151,290,medium-high-risk
64806,44,136,205,385,high-risk
64824,0,0,0,0,low-risk
64827,40,158,223,421,high-risk
64831,0,0,0,0,low-risk
64833,0,0,0,0,low-risk
64835,0,0,0,0,low-risk
64850,24,119,169,312,medium-high-risk
64884,12,142,184,338,high-risk
64890,11,128,169,308,medium-high-risk
64904,21,102,147,270,medium-high-risk
64923,16,97,149,262,medium-high-risk
64928,0,0,0,0,low-risk
64930,22,165,204,391,high-risk
64939,0,0,0,0,low-risk
64943,37,122,162,321,medium-high-risk
64949,0,0,0,0,low-risk
64959,12,122,167,301,medium-high-risk
64960,43,219,198,460,high-risk
64961,0,0,0,0,low-risk
64963,0,0,0,0,low-risk
64966,12,52,85,149,medium-low-risk
64972,16,69,127,212,medium-low-risk
64973,0,0,0,0,low-risk
64983,12,99,116,227,medium-low-risk
64993,12,119,155,286,medium-high-risk
64994,11,103,141,255,medium-high-risk
65002,12,93,82,187,medium-low-risk
65010,11,131,152,294,medium-high-risk
65012,12,136,146,294,medium-high-risk
65023,12,99,136,247,medium-high-risk
65034,0,0,0,0,low-risk
65036,33,122,174,329,medium-high-risk
65044,12,161,230,403,high-risk
65047,0,0,0,0,low-risk
65056,0,0,0,0,low-risk
65063,12,111,125,248,medium-high-risk
65064,0,0,0,0,low-risk
65065,0,0,0,0,low-risk
65079,0,0,0,0,low-risk
6508,12,108,141,261,medium-high-risk
65080,33,218,266,517,high-risk
65081,12,162,220,394,high-risk
65086,0,0,0,0,low-risk
65094,0,0,0,0,low-risk
65103,0,0,0,0,low-risk
65106,0,0,0,0,low-risk
65108,12,197,241,450,high-risk
65112,12,131,176,319,medium-high-risk
65119,15,124,215,354,high-risk
65128,23,142,190,355,high-risk
65133,12,165,188,365,high-risk
65140,0,0,0,0,low-risk
65143,0,0,0,0,low-risk
65151,20,143,265,428,high-risk
65168,13,124,145,282,medium-high-risk
6517,12,118,150,280,medium-high-risk
65171,39,120,173,332,high-risk
65174,0,0,0,0,low-risk
65178,12,144,235,391,high-risk
6518,12,100,128,240,medium-low-risk
6519,0,0,0,0,low-risk
65194,0,0,0,0,low-risk
65197,24,84,121,229,medium-low-risk
6521,0,0,0,0,low-risk
65219,12,104,133,249,medium-high-risk
65220,0,0,0,0,low-risk
65229,0,0,0,0,low-risk
65240,0,0,0,0,low-risk
65250,0,0,0,0,low-risk
65268,0,0,0,0,low-risk
65270,0,0,0,0,low-risk
65280,12,114,129,255,medium-high-risk
65284,0,0,0,0,low-risk
65285,16,89,134,239,medium-low-risk
65289,0,0,0,0,low-risk
65293,37,172,204,413,high-risk
65294,12,111,144,267,medium-high-risk
65310,16,102,155,273,medium-high-risk
65313,0,0,0,0,low-risk
6532,0,0,0,0,low-risk
65342,12,105,186,303,medium-high-risk
65347,43,163,244,450,high-risk
65350,12,126,158,296,medium-high-risk
65352,0,0,0,0,low-risk
6536,12,161,151,324,medium-high-risk
65369,30,112,179,321,medium-high-risk
65384,0,0,0,0,low-risk
65396,12,155,186,353,high-risk
65398,0,0,0,0,low-risk
6540,46,124,170,340,high-risk
65400,12,84,123,219,medium-low-risk
65401,37,107,250,394,high-risk
65406,0,0,0,0,low-risk
65407,0,0,0,0,low-risk
65414,0,0,0,0,low-risk
65423,0,0,0,0,low-risk
65426,0,0,0,0,low-risk
65427,12,98,128,238,medium-low-risk
6545,11,132,152,295,medium-high-risk
65450,0,0,0,0,low-risk
65456,12,161,196,369,high-risk
65459,0,0,0,0,low-risk
65469,0,0,0,0,low-risk
65471,12,129,157,298,medium-high-risk
65478,21,157,207,385,high-risk
65481,49,141,219,409,high-risk
65487,0,0,0,0,low-risk
65491,15,112,148,275,medium-high-risk
65493,0,0,0,0,low-risk
65496,30,136,191,357,high-risk
65497,28,113,162,303,medium-high-risk
65498,0,0,0,0,low-risk
65499,12,116,222,350,high-risk
65522,12,119,160,291,medium-high-risk
65526,12,114,159,285,medium-high-risk
65538,12,126,196,334,high-risk
65558,0,0,0,0,low-risk
65564,25,168,216,409,high-risk
65578,18,115,181,314,medium-high-risk
65581,12,98,160,270,medium-high-risk
65612,12,107,131,250,medium-high-risk
65615,16,113,189,318,medium-high-risk
65616,0,0,0,0,low-risk
65628,0,0,0,0,low-risk
6563,49,121,185,355,high-risk
65634,24,161,229,414,high-risk
65639,12,124,166,302,medium-high-risk
65643,12,138,148,298,medium-high-risk
65649,12,145,189,346,high-risk
65655,0,0,0,0,low-risk
6566,0,0,0,0,low-risk
65669,12,76,97,185,medium-low-risk
6567,17,152,217,386,high-risk
6568,0,0,0,0,low-risk
65684,0,0,0,0,low-risk
6569,0,0,0,0,low-risk
65691,0,0,0,0,low-risk
65695,0,0,0,0,low-risk
65703,0,0,0,0,low-risk
65732,12,96,143,251,medium-high-risk
6574,12,151,178,341,high-risk
65744,12,137,173,322,medium-high-risk
6575,24,125,162,311,medium-high-risk
65755,0,0,0,0,low-risk
65757,12,128,206,346,high-risk
65769,0,0,0,0,low-risk
65781,13,105,117,235,medium-low-risk
65786,36,136,180,352,high-risk
65789,0,0,0,0,low-risk
65794,0,0,0,0,low-risk
65800,20,102,148,270,medium-high-risk
65802,12,106,126,244,medium-low-risk
65805,0,0,0,0,low-risk
65807,21,122,189,332,high-risk
65824,13,79,139,231,medium-low-risk
65826,12,126,149,287,medium-high-risk
65834,23,127,177,327,medium-high-risk
65842,0,0,0,0,low-risk
65855,0,0,0,0,low-risk
65861,11,122,157,290,medium-high-risk
65870,51,172,194,417,high-risk
65883,16,127,170,313,medium-high-risk
65884,34,115,156,305,medium-high-risk
6589,32,146,204,382,high-risk
65897,12,107,146,265,medium-high-risk
65913,12,87,116,215,medium-low-risk
65914,40,142,211,393,high-risk
65915,0,0,0,0,low-risk
65917,15,160,182,357,high-risk
65922,61,180,308,549,high-risk
65929,31,150,170,351,high-risk
65935,34,127,148,309,medium-high-risk
65946,0,0,0,0,low-risk
65960,13,143,181,337,high-risk
65968,0,0,0,0,low-risk
65970,0,0,0,0,low-risk
65975,0,0,0,0,low-risk
65978,12,175,188,375,high-risk
65979,42,116,191,349,high-risk
6599,0,0,0,0,low-risk
65991,19,111,193,323,medium-high-risk
66003,0,0,0,0,low-risk
66006,62,187,289,538,high-risk
66020,22,131,161,314,medium-high-risk
66029,12,102,122,236,medium-low-risk
66041,12,95,124,231,medium-low-risk
66049,12,99,139,250,medium-high-risk
66054,13,110,182,305,medium-high-risk
66057,0,0,0,0,low-risk
66064,12,91,125,228,medium-low-risk
66065,20,80,152,252,medium-high-risk
66068,0,0,0,0,low-risk
6607,0,0,0,0,low-risk
66081,0,0,0,0,low-risk
66095,0,0,0,0,low-risk
66097,12,146,179,337,high-risk
66099,31,146,208,385,high-risk
6610,0,0,0,0,low-risk
66106,12,102,171,285,medium-high-risk
66113,12,122,136,270,medium-high-risk
66124,0,0,0,0,low-risk
66136,14,79,127,220,medium-low-risk
6614,0,0,0,0,low-risk
66142,0,0,0,0,low-risk
66154,12,140,153,305,medium-high-risk
66157,0,0,0,0,low-risk
6616,13,179,232,424,high-risk
66160,0,0,0,0,low-risk
66168,0,0,0,0,low-risk
66170,49,213,325,587,high-risk
66172,12,118,130,260,medium-high-risk
66182,12,135,158,305,medium-high-risk
66183,12,122,194,328,medium-high-risk
66188,23,96,128,247,medium-high-risk
66192,0,0,0,0,low-risk
66193,0,0,0,0,low-risk
66196,14,107,153,274,medium-high-risk
6620,0,0,0,0,low-risk
66200,25,149,207,381,high-risk
66203,12,140,206,358,high-risk
66219,0,0,0,0,low-risk
66220,33,168,193,394,high-risk
66230,0,0,0,0,low-risk
66232,12,84,115,211,medium-low-risk
66236,0,0,0,0,low-risk
66237,12,111,138,261,medium-high-risk
66244,12,37,68,117,medium-low-risk
66250,27,110,143,280,medium-high-risk
66261,12,126,156,294,medium-high-risk
66262,0,0,0,0,low-risk
6627,12,87,117,216,medium-low-risk
66274,0,0,0,0,low-risk
66290,16,149,203,368,high-risk
66294,12,96,116,224,medium-low-risk
66312,0,0,0,0,low-risk
66314,11,152,221,384,high-risk
66315,12,134,167,313,medium-high-risk
66335,22,135,237,394,high-risk
66350,38,160,232,430,high-risk
66351,0,0,0,0,low-risk
66359,0,0,0,0,low-risk
66363,21,139,226,386,high-risk
66364,0,0,0,0,low-risk
66365,0,0,0,0,low-risk
66366,0,0,0,0,low-risk
66374,0,0,0,0,low-risk
66383,12,75,87,174,medium-low-risk
66387,23,118,169,310,medium-high-risk
66389,0,0,0,0,low-risk
66395,0,0,0,0,low-risk
66397,21,125,148,294,medium-high-risk
66401,0,0,0,0,low-risk
66414,32,116,180,328,medium-high-risk
66418,12,116,115,243,medium-low-risk
66428,22,137,161,320,medium-high-risk
66433,12,190,209,411,high-risk
66436,12,153,236,401,high-risk
66452,0,0,0,0,low-risk
66455,31,147,170,348,high-risk
66456,12,97,135,244,medium-low-risk
66466,0,0,0,0,low-risk
66470,0,0,0,0,low-risk
66476,36,146,191,373,high-risk
66483,11,119,170,300,medium-high-risk
6650,12,134,172,318,medium-high-risk
66502,0,0,0,0,low-risk
66503,36,115,149,300,medium-high-risk
66505,0,0,0,0,low-risk
6651,12,116,199,327,medium-high-risk
66515,12,127,211,350,high-risk
6653,12,129,215,356,high-risk
66539,12,130,138,280,medium-high-risk
66550,0,0,0,0,low-risk
66554,0,0,0,0,low-risk
66566,12,164,265,441,high-risk
66568,26,127,175,328,medium-high-risk
66574,0,0,0,0,low-risk
66580,39,123,160,322,medium-high-risk
66581,14,80,109,203,medium-low-risk
66584,0,0,0,0,low-risk
66597,0,0,0,0,low-risk
66600,0,0,0,0,low-risk
66604,15,140,217,372,high-risk
66605,13,131,226,370,high-risk
66611,22,108,146,276,medium-high-risk
66622,13,97,110,220,medium-low-risk
66623,12,106,145,263,medium-high-risk
66627,12,146,211,369,high-risk
66629,0,0,0,0,low-risk
6663,0,0,0,0,low-risk
66635,12,121,179,312,medium-high-risk
66642,12,146,184,342,high-risk
66657,12,109,215,336,high-risk
66660,0,0,0,0,low-risk
66662,0,0,0,0,low-risk
66667,0,0,0,0,low-risk
66697,0,0,0,0,low-risk
66699,12,114,227,353,high-risk
66705,0,0,0,0,low-risk
66715,12,111,137,260,medium-high-risk
66723,18,72,120,210,medium-low-risk
66726,0,0,0,0,low-risk
66729,28,176,277,481,high-risk
66742,12,104,144,260,medium-high-risk
66748,0,0,0,0,low-risk
66756,0,0,0,0,low-risk
66759,12,125,157,294,medium-high-risk
6677,29,118,156,303,medium-high-risk
66774,30,116,155,301,medium-high-risk
66781,0,0,0,0,low-risk
6679,12,129,142,283,medium-high-risk
66799,12,137,174,323,medium-high-risk
66807,12,175,235,422,high-risk
66808,0,0,0,0,low-risk
66812,0,0,0,0,low-risk
66813,0,0,0,0,low-risk
66817,12,122,164,298,medium-high-risk
66819,0,0,0,0,low-risk
66821,36,114,148,298,medium-high-risk
66844,0,0,0,0,low-risk
66852,36,112,148,296,medium-high-risk
66859,12,139,158,309,medium-high-risk
66866,12,137,186,335,high-risk
66869,12,109,149,270,medium-high-risk
66886,12,120,185,317,medium-high-risk
66887,12,123,196,331,high-risk
66891,29,110,153,292,medium-high-risk
66892,12,101,146,259,medium-high-risk
66895,0,0,0,0,low-risk
66898,12,126,162,300,medium-high-risk
66899,12,112,151,275,medium-high-risk
66903,0,0,0,0,low-risk
66905,12,95,158,265,medium-high-risk
66919,0,0,0,0,low-risk
6692,12,119,158,289,medium-high-risk
66923,34,100,170,304,medium-high-risk
66931,15,107,165,287,medium-high-risk
66933,14,67,125,206,medium-low-risk
66941,12,124,141,277,medium-high-risk
66944,12,114,150,276,medium-high-risk
66949,12,121,139,272,medium-high-risk
66954,0,0,0,0,low-risk
66956,12,111,125,248,medium-high-risk
66958,33,190,278,501,high-risk
66960,0,0,0,0,low-risk
66961,44,129,162,335,high-risk
66965,15,229,189,433,high-risk
66968,0,0,0,0,low-risk
66973,12,102,144,258,medium-high-risk
66974,0,0,0,0,low-risk
66979,0,0,0,0,low-risk
66986,12,88,114,214,medium-low-risk
67003,0,0,0,0,low-risk
67005,15,118,182,315,medium-high-risk
67016,12,106,143,261,medium-high-risk
67017,12,138,201,351,high-risk
67023,0,0,0,0,low-risk
6703,0,0,0,0,low-risk
67032,0,0,0,0,low-risk
67035,0,0,0,0,low-risk
67036,0,0,0,0,low-risk
67046,0,0,0,0,low-risk
67051,0,0,0,0,low-risk
67060,0,0,0,0,low-risk
67073,0,0,0,0,low-risk
67074,14,140,183,337,high-risk
67076,0,0,0,0,low-risk
67081,31,139,179,349,high-risk
67098,12,88,117,217,medium-low-risk
67115,0,0,0,0,low-risk
67117,13,141,200,354,high-risk
67119,30,155,200,385,high-risk
67120,12,134,84,230,medium-low-risk
67125,0,0,0,0,low-risk
67129,0,0,0,0,low-risk
67130,0,0,0,0,low-risk
67135,40,157,188,385,high-risk
67138,0,0,0,0,low-risk
6714,0,0,0,0,low-risk
67143,15,118,166,299,medium-high-risk
67152,13,148,162,323,medium-high-risk
67153,0,0,0,0,low-risk
67160,46,138,190,374,high-risk
67165,0,0,0,0,low-risk
67169,33,108,155,296,medium-high-risk
67173,0,0,0,0,low-risk
67176,35,164,221,420,high-risk
67182,12,168,185,365,high-risk
67186,0,0,0,0,low-risk
6719,0,0,0,0,low-risk
67196,0,0,0,0,low-risk
67203,15,129,175,319,medium-high-risk
6721,0,0,0,0,low-risk
67215,12,135,163,310,medium-high-risk
67237,0,0,0,0,low-risk
67243,0,0,0,0,low-risk
67244,12,141,163,316,medium-high-risk
67252,41,128,172,341,high-risk
67259,12,129,214,355,high-risk
67260,0,0,0,0,low-risk
67267,0,0,0,0,low-risk
67270,25,116,168,309,medium-high-risk
67276,0,0,0,0,low-risk
67297,12,160,86,258,medium-high-risk
67308,12,92,115,219,medium-low-risk
6732,0,0,0,0,low-risk
67338,14,112,166,292,medium-high-risk
67343,0,0,0,0,low-risk
67349,12,128,175,315,medium-high-risk
6736,0,0,0,0,low-risk
67370,12,81,119,212,medium-low-risk
67371,16,169,213,398,high-risk
67373,22,129,181,332,high-risk
67377,0,0,0,0,low-risk
67382,15,200,283,498,high-risk
67385,0,0,0,0,low-risk
67399,0,0,0,0,low-risk
67410,39,141,206,386,high-risk
67414,19,133,196,348,high-risk
67415,0,0,0,0,low-risk
67432,0,0,0,0,low-risk
67440,12,111,138,261,medium-high-risk
67457,13,142,165,320,medium-high-risk
67464,0,0,0,0,low-risk
67467,22,93,146,261,medium-high-risk
67475,12,95,238,345,high-risk
67486,24,146,184,354,high-risk
67492,0,0,0,0,low-risk
67497,18,160,206,384,high-risk
6750,0,0,0,0,low-risk
67503,12,88,144,244,medium-low-risk
67511,0,0,0,0,low-risk
67515,12,141,188,341,high-risk
67516,42,136,199,377,high-risk
67521,0,0,0,0,low-risk
67532,29,181,255,465,high-risk
67535,0,0,0,0,low-risk
67537,0,0,0,0,low-risk
67539,53,255,279,587,high-risk
6754,12,145,173,330,high-risk
67549,14,110,135,259,medium-high-risk
67559,12,141,235,388,high-risk
6757,0,0,0,0,low-risk
67574,12,94,129,235,medium-low-risk
67575,0,0,0,0,low-risk
67579,12,170,241,423,high-risk
67584,12,168,304,484,high-risk
67586,0,0,0,0,low-risk
67587,0,0,0,0,low-risk
67591,27,102,173,302,medium-high-risk
67592,39,137,188,364,high-risk
67599,12,129,118,259,medium-high-risk
67603,17,143,162,322,medium-high-risk
67613,13,108,151,272,medium-high-risk
67626,15,161,272,448,high-risk
67627,12,116,158,286,medium-high-risk
67640,12,151,233,396,high-risk
67652,12,185,228,425,high-risk
67653,0,0,0,0,low-risk
67666,0,0,0,0,low-risk
67679,0,0,0,0,low-risk
67693,12,155,172,339,high-risk
67695,12,131,204,347,high-risk
6770,0,0,0,0,low-risk
67725,26,72,148,246,medium-high-risk
67726,0,0,0,0,low-risk
67733,0,0,0,0,low-risk
67754,0,0,0,0,low-risk
67758,0,0,0,0,low-risk
67778,22,122,167,311,medium-high-risk
67779,12,167,218,397,high-risk
67784,12,113,145,270,medium-high-risk
67789,0,0,0,0,low-risk
67792,13,140,323,476,high-risk
67795,28,140,177,345,high-risk
67796,31,131,159,321,medium-high-risk
67797,0,0,0,0,low-risk
67804,23,117,159,299,medium-high-risk
67809,11,125,145,281,medium-high-risk
67815,0,0,0,0,low-risk
6782,19,126,185,330,high-risk
67827,32,159,254,445,high-risk
67828,0,0,0,0,low-risk
67833,0,0,0,0,low-risk
67834,0,0,0,0,low-risk
67840,12,104,150,266,medium-high-risk
67845,0,0,0,0,low-risk
67851,0,0,0,0,low-risk
67853,12,113,150,275,medium-high-risk
67856,0,0,0,0,low-risk
67863,17,81,149,247,medium-high-risk
67873,12,130,165,307,medium-high-risk
67885,0,0,0,0,low-risk
67891,30,135,179,344,high-risk
67897,21,123,172,316,medium-high-risk
67898,0,0,0,0,low-risk
67899,12,122,185,319,medium-high-risk
67909,15,113,209,337,high-risk
67912,0,0,0,0,low-risk
67920,0,0,0,0,low-risk
67924,12,105,143,260,medium-high-risk
67937,0,0,0,0,low-risk
67943,20,167,188,375,high-risk
67945,27,95,150,272,medium-high-risk
67946,12,124,155,291,medium-high-risk
67950,0,0,0,0,low-risk
67954,19,158,193,370,high-risk
67962,23,116,180,319,medium-high-risk
67966,12,163,194,369,high-risk
67968,32,118,172,322,medium-high-risk
67977,12,126,152,290,medium-high-risk
67981,0,0,0,0,low-risk
67983,22,113,157,292,medium-high-risk
67986,0,0,0,0,low-risk
67991,0,0,0,0,low-risk
67996,0,0,0,0,low-risk
68003,0,0,0,0,low-risk
68011,0,0,0,0,low-risk
68018,12,107,144,263,medium-high-risk
68022,15,132,238,385,high-risk
68033,12,99,143,254,medium-high-risk
68037,14,140,238,392,high-risk
68039,24,152,239,415,high-risk
68042,18,102,169,289,medium-high-risk
68053,0,0,0,0,low-risk
68061,12,112,164,288,medium-high-risk
68067,11,112,154,277,medium-high-risk
68069,0,0,0,0,low-risk
68078,29,144,182,355,high-risk
68083,0,0,0,0,low-risk
68085,12,119,199,330,high-risk
6809,12,85,124,221,medium-low-risk
68097,30,96,131,257,medium-high-risk
68105,29,123,161,313,medium-high-risk
68108,12,142,160,314,medium-high-risk
68111,0,0,0,0,low-risk
6812,0,0,0,0,low-risk
68128,0,0,0,0,low-risk
68129,0,0,0,0,low-risk
68134,12,158,186,356,high-risk
68137,12,123,182,317,medium-high-risk
68139,0,0,0,0,low-risk
68152,27,146,178,351,high-risk
68161,16,117,147,280,medium-high-risk
68163,12,110,159,281,medium-high-risk
68168,0,0,0,0,low-risk
68181,0,0,0,0,low-risk
68183,0,0,0,0,low-risk
68186,0,0,0,0,low-risk
68192,0,0,0,0,low-risk
68198,12,122,158,292,medium-high-risk
68207,23,152,193,368,high-risk
68212,20,129,248,397,high-risk
6822,0,0,0,0,low-risk
68226,0,0,0,0,low-risk
68230,12,148,171,331,high-risk
68236,29,122,177,328,medium-high-risk
68242,44,226,193,463,high-risk
68243,37,158,302,497,high-risk
68247,0,0,0,0,low-risk
68273,0,0,0,0,low-risk
68275,12,124,141,277,medium-high-risk
68276,12,115,145,272,medium-high-risk
68286,0,0,0,0,low-risk
6829,14,147,257,418,high-risk
68290,24,107,151,282,medium-high-risk
68296,0,0,0,0,low-risk
68297,32,133,147,312,medium-high-risk
68301,12,115,216,343,high-risk
68326,0,0,0,0,low-risk
68337,12,154,166,332,high-risk
6835,0,0,0,0,low-risk
68360,12,148,194,354,high-risk
68361,0,0,0,0,low-risk
68362,22,96,137,255,medium-high-risk
68367,0,0,0,0,low-risk
68374,23,115,145,283,medium-high-risk
68376,29,112,148,289,medium-high-risk
68378,12,128,181,321,medium-high-risk
68390,37,106,167,310,medium-high-risk
68398,15,166,236,417,high-risk
68405,0,0,0,0,low-risk
68414,13,101,137,251,medium-high-risk
6842,16,79,133,228,medium-low-risk
68429,12,147,180,339,high-risk
68438,36,157,200,393,high-risk
68445,43,131,186,360,high-risk
68455,12,149,168,329,medium-high-risk
6846,0,0,0,0,low-risk
68463,0,0,0,0,low-risk
68476,0,0,0,0,low-risk
68478,25,132,268,425,high-risk
68482,27,175,245,447,high-risk
68485,0,0,0,0,low-risk
6849,0,0,0,0,low-risk
68493,12,134,166,312,medium-high-risk
68501,12,164,204,380,high-risk
68510,0,0,0,0,low-risk
68511,12,143,182,337,high-risk
68513,19,96,131,246,medium-high-risk
68514,25,105,141,271,medium-high-risk
68518,0,0,0,0,low-risk
68520,19,175,253,447,high-risk
68529,24,101,148,273,medium-high-risk
68543,0,0,0,0,low-risk
68557,0,0,0,0,low-risk
68562,12,100,128,240,medium-low-risk
68563,12,131,169,312,medium-high-risk
68565,0,0,0,0,low-risk
68570,0,0,0,0,low-risk
68572,0,0,0,0,low-risk
6858,0,0,0,0,low-risk
68580,13,122,171,306,medium-high-risk
6859,0,0,0,0,low-risk
68592,0,0,0,0,low-risk
68605,60,154,247,461,high-risk
68609,14,138,174,326,medium-high-risk
68611,0,0,0,0,low-risk
68616,0,0,0,0,low-risk
68618,24,93,137,254,medium-high-risk
68639,26,123,152,301,medium-high-risk
68643,0,0,0,0,low-risk
68649,0,0,0,0,low-risk
68650,18,119,176,313,medium-high-risk
68656,12,118,156,286,medium-high-risk
68657,12,155,187,354,high-risk
68660,0,0,0,0,low-risk
68684,0,0,0,0,low-risk
68698,0,0,0,0,low-risk
68704,12,145,184,341,high-risk
68705,12,105,120,237,medium-low-risk
68711,13,85,107,205,medium-low-risk
68716,15,117,237,369,high-risk
68720,12,129,167,308,medium-high-risk
6874,17,130,195,342,high-risk
68745,0,0,0,0,low-risk
68749,12,163,180,355,high-risk
68755,12,94,126,232,medium-low-risk
68780,13,127,266,406,high-risk
68828,14,85,132,231,medium-low-risk
68829,12,100,130,242,medium-low-risk
68833,42,170,202,414,high-risk
68834,0,0,0,0,low-risk
68836,12,119,183,314,medium-high-risk
68845,0,0,0,0,low-risk
68846,0,0,0,0,low-risk
68848,11,70,99,180,medium-low-risk
68855,12,98,129,239,medium-low-risk
68870,32,109,157,298,medium-high-risk
68873,12,147,174,333,high-risk
6888,0,0,0,0,low-risk
68883,24,78,164,266,medium-high-risk
6889,12,114,158,284,medium-high-risk
68890,12,137,146,295,medium-high-risk
68899,0,0,0,0,low-risk
6892,12,138,152,302,medium-high-risk
68921,0,0,0,0,low-risk
68926,46,126,236,408,high-risk
68934,13,106,133,252,medium-high-risk
68956,0,0,0,0,low-risk
68957,12,92,124,228,medium-low-risk
68978,32,142,200,374,high-risk
68979,12,163,222,397,high-risk
68986,33,92,184,309,medium-high-risk
6900,12,125,161,298,medium-high-risk
69020,0,0,0,0,low-risk
69025,0,0,0,0,low-risk
6903,0,0,0,0,low-risk
69030,18,210,192,420,high-risk
69043,30,119,149,298,medium-high-risk
69044,12,103,202,317,medium-high-risk
6905,0,0,0,0,low-risk
69067,0,0,0,0,low-risk
69072,12,93,136,241,medium-low-risk
69075,0,0,0,0,low-risk
69077,0,0,0,0,low-risk
69087,0,0,0,0,low-risk
69089,0,0,0,0,low-risk
69096,12,112,162,286,medium-high-risk
6910,0,0,0,0,low-risk
69103,0,0,0,0,low-risk
69108,0,0,0,0,low-risk
6913,0,0,0,0,low-risk
69133,0,0,0,0,low-risk
69136,0,0,0,0,low-risk
69144,0,0,0,0,low-risk
69160,31,101,155,287,medium-high-risk
69162,0,0,0,0,low-risk
69171,0,0,0,0,low-risk
69176,12,114,135,261,medium-high-risk
6919,44,164,232,440,high-risk
6920,12,97,109,218,medium-low-risk
69200,15,95,137,247,medium-high-risk
69212,0,0,0,0,low-risk
6922,15,114,160,289,medium-high-risk
69221,0,0,0,0,low-risk
69222,0,0,0,0,low-risk
69228,12,134,83,229,medium-low-risk
69229,0,0,0,0,low-risk
6924,11,76,130,217,medium-low-risk
69240,0,0,0,0,low-risk
69243,0,0,0,0,low-risk
69247,0,0,0,0,low-risk
69250,34,137,196,367,high-risk
69266,32,136,163,331,high-risk
69276,0,0,0,0,low-risk
69277,22,124,207,353,high-risk
69279,30,150,436,616,high-risk
69286,15,149,161,325,medium-high-risk
69305,32,167,219,418,high-risk
69314,0,0,0,0,low-risk
69315,0,0,0,0,low-risk
69317,0,0,0,0,low-risk
69323,0,0,0,0,low-risk
69330,16,169,198,383,high-risk
69331,0,0,0,0,low-risk
69340,12,166,222,400,high-risk
69344,0,0,0,0,low-risk
6935,12,106,149,267,medium-high-risk
69352,55,147,180,382,high-risk
69356,0,0,0,0,low-risk
69360,0,0,0,0,low-risk
69361,12,132,176,320,medium-high-risk
69367,13,117,193,323,medium-high-risk
69368,0,0,0,0,low-risk
69369,0,0,0,0,low-risk
69373,30,128,176,334,high-risk
69398,12,149,163,324,medium-high-risk
6940,0,0,0,0,low-risk
69403,0,0,0,0,low-risk
69405,13,85,141,239,medium-low-risk
69407,0,0,0,0,low-risk
69411,12,132,185,329,medium-high-risk
69416,0,0,0,0,low-risk
69439,0,0,0,0,low-risk
69440,0,0,0,0,low-risk
69449,12,144,164,320,medium-high-risk
69459,0,0,0,0,low-risk
6947,12,133,145,290,medium-high-risk
69478,0,0,0,0,low-risk
69481,15,138,198,351,high-risk
69488,23,117,177,317,medium-high-risk
69499,12,139,145,296,medium-high-risk
69512,12,131,244,387,high-risk
6952,0,0,0,0,low-risk
69523,12,120,165,297,medium-high-risk
69533,18,143,217,378,high-risk
69537,0,0,0,0,low-risk
69539,0,0,0,0,low-risk
69541,0,0,0,0,low-risk
69547,12,113,151,276,medium-high-risk
69549,12,117,175,304,medium-high-risk
69556,0,0,0,0,low-risk
69562,14,142,184,340,high-risk
69563,0,0,0,0,low-risk
69564,13,125,173,311,medium-high-risk
6957,12,112,166,290,medium-high-risk
69584,0,0,0,0,low-risk
69617,12,117,140,269,medium-high-risk
69629,0,0,0,0,low-risk
69632,17,136,267,420,high-risk
69635,12,58,60,130,medium-low-risk
69639,26,136,195,357,high-risk
69646,0,0,0,0,low-risk
69647,0,0,0,0,low-risk
69652,12,129,159,300,medium-high-risk
69669,23,120,175,318,medium-high-risk
69670,0,0,0,0,low-risk
69680,12,113,146,271,medium-high-risk
69683,12,91,184,287,medium-high-risk
69694,0,0,0,0,low-risk
69695,0,0,0,0,low-risk
69698,25,113,146,284,medium-high-risk
69702,0,0,0,0,low-risk
69710,17,134,229,380,high-risk
69711,12,75,105,192,medium-low-risk
69726,0,0,0,0,low-risk
69728,14,135,234,383,high-risk
6974,0,0,0,0,low-risk
69744,12,116,153,281,medium-high-risk
69747,0,0,0,0,low-risk
69751,0,0,0,0,low-risk
69762,0,0,0,0,low-risk
69769,12,119,92,223,medium-low-risk
69773,12,148,168,328,medium-high-risk
69775,25,141,183,349,high-risk
69780,20,156,209,385,high-risk
69788,25,157,244,426,high-risk
69792,21,82,229,332,high-risk
69794,12,98,132,242,medium-low-risk
69809,0,0,0,0,low-risk
69815,0,0,0,0,low-risk
69839,13,106,149,268,medium-high-risk
69840,0,0,0,0,low-risk
69843,0,0,0,0,low-risk
69847,12,133,231,376,high-risk
69848,0,0,0,0,low-risk
69854,12,112,121,245,medium-high-risk
69872,12,113,150,275,medium-high-risk
69873,0,0,0,0,low-risk
69880,33,127,174,334,high-risk
69884,0,0,0,0,low-risk
69891,12,122,162,296,medium-high-risk
69895,0,0,0,0,low-risk
69899,0,0,0,0,low-risk
69900,0,0,0,0,low-risk
69906,0,0,0,0,low-risk
69919,0,0,0,0,low-risk
69920,17,89,130,236,medium-low-risk
69923,0,0,0,0,low-risk
69924,12,168,191,371,high-risk
69926,0,0,0,0,low-risk
6994,0,0,0,0,low-risk
69941,42,138,231,411,high-risk
69946,0,0,0,0,low-risk
69959,12,151,215,378,high-risk
69961,0,0,0,0,low-risk
69964,0,0,0,0,low-risk
69983,0,0,0,0,low-risk
69987,0,0,0,0,low-risk
69992,0,0,0,0,low-risk
70007,0,0,0,0,low-risk
70013,11,102,128,241,medium-low-risk
70014,17,120,170,307,medium-high-risk
7002,12,159,217,388,high-risk
70023,0,0,0,0,low-risk
70026,33,155,205,393,high-risk
70037,20,134,192,346,high-risk
70046,12,118,79,209,medium-low-risk
70052,0,0,0,0,low-risk
70057,15,80,109,204,medium-low-risk
7006,0,0,0,0,low-risk
70070,14,125,166,305,medium-high-risk
70075,28,167,208,403,high-risk
7008,0,0,0,0,low-risk
70088,12,134,166,312,medium-high-risk
70095,0,0,0,0,low-risk
70114,0,0,0,0,low-risk
7012,0,0,0,0,low-risk
70128,0,0,0,0,low-risk
70129,0,0,0,0,low-risk
70133,0,0,0,0,low-risk
7014,12,149,184,345,high-risk
70146,13,143,176,332,high-risk
70152,12,201,144,357,high-risk
70154,12,150,194,356,high-risk
70158,12,130,207,349,high-risk
70162,12,137,184,333,high-risk
70163,48,166,219,433,high-risk
70164,12,140,165,317,medium-high-risk
70168,0,0,0,0,low-risk
70174,0,0,0,0,low-risk
7018,12,120,191,323,medium-high-risk
70188,22,79,118,219,medium-low-risk
7020,19,196,262,477,high-risk
70215,17,100,145,262,medium-high-risk
7023,0,0,0,0,low-risk
70238,12,154,196,362,high-risk
70239,0,0,0,0,low-risk
70245,0,0,0,0,low-risk
70248,12,95,135,242,medium-low-risk
7025,26,152,199,377,high-risk
70253,0,0,0,0,low-risk
70256,0,0,0,0,low-risk
70265,0,0,0,0,low-risk
70266,0,0,0,0,low-risk
70273,0,0,0,0,low-risk
70276,29,104,164,297,medium-high-risk
70284,0,0,0,0,low-risk
70285,0,0,0,0,low-risk
70287,0,0,0,0,low-risk
70290,13,158,228,399,high-risk
70299,12,107,151,270,medium-high-risk
70302,37,156,223,416,high-risk
70318,29,112,134,275,medium-high-risk
70322,15,80,125,220,medium-low-risk
70326,0,0,0,0,low-risk
70337,42,150,215,407,high-risk
70342,12,126,155,293,medium-high-risk
70350,0,0,0,0,low-risk
70356,0,0,0,0,low-risk
70357,25,95,184,304,medium-high-risk
70360,0,0,0,0,low-risk
70361,14,61,240,315,medium-high-risk
70367,0,0,0,0,low-risk
70384,0,0,0,0,low-risk
7039,12,167,197,376,high-risk
70391,12,117,130,259,medium-high-risk
70395,0,0,0,0,low-risk
7041,12,228,152,392,high-risk
70417,56,123,243,422,high-risk
70423,0,0,0,0,low-risk
70435,14,135,191,340,high-risk
70442,39,156,234,429,high-risk
70452,12,139,170,321,medium-high-risk
70462,0,0,0,0,low-risk
70463,0,0,0,0,low-risk
70476,12,218,176,406,high-risk
70478,13,119,153,285,medium-high-risk
70480,0,0,0,0,low-risk
70484,12,144,154,310,medium-high-risk
70489,12,139,186,337,high-risk
70494,24,156,200,380,high-risk
70503,20,114,140,274,medium-high-risk
70505,34,147,181,362,high-risk
70507,23,206,150,379,high-risk
70524,0,0,0,0,low-risk
70534,0,0,0,0,low-risk
70539,12,151,178,341,high-risk
70561,0,0,0,0,low-risk
70572,0,0,0,0,low-risk
7058,12,150,299,461,high-risk
70582,0,0,0,0,low-risk
70587,0,0,0,0,low-risk
7059,12,114,137,263,medium-high-risk
70597,18,92,136,246,medium-high-risk
70599,0,0,0,0,low-risk
70613,0,0,0,0,low-risk
70616,0,0,0,0,low-risk
70622,0,0,0,0,low-risk
70627,0,0,0,0,low-risk
70629,12,89,123,224,medium-low-risk
7063,0,0,0,0,low-risk
70632,30,100,153,283,medium-high-risk
70637,0,0,0,0,low-risk
70638,0,0,0,0,low-risk
70643,12,168,186,366,high-risk
70661,0,0,0,0,low-risk
70670,0,0,0,0,low-risk
70683,16,91,126,233,medium-low-risk
70691,0,0,0,0,low-risk
70695,0,0,0,0,low-risk
70697,0,0,0,0,low-risk
70703,0,0,0,0,low-risk
70709,12,178,203,393,high-risk
7072,12,124,177,313,medium-high-risk
70729,15,65,217,297,medium-high-risk
7073,12,116,157,285,medium-high-risk
70759,12,128,170,310,medium-high-risk
70772,17,118,175,310,medium-high-risk
70785,0,0,0,0,low-risk
70789,0,0,0,0,low-risk
70792,0,0,0,0,low-risk
70814,28,109,141,278,medium-high-risk
70816,0,0,0,0,low-risk
70819,17,143,296,456,high-risk
70821,12,93,194,299,medium-high-risk
70827,16,123,162,301,medium-high-risk
70829,0,0,0,0,low-risk
70830,24,139,160,323,medium-high-risk
70834,0,0,0,0,low-risk
70835,25,128,166,319,medium-high-risk
7085,0,0,0,0,low-risk
70850,12,126,155,293,medium-high-risk
70855,0,0,0,0,low-risk
70866,27,118,188,333,high-risk
70869,0,0,0,0,low-risk
70873,24,103,182,309,medium-high-risk
70875,12,116,144,272,medium-high-risk
7088,33,138,171,342,high-risk
70880,0,0,0,0,low-risk
70881,0,0,0,0,low-risk
70887,12,82,113,207,medium-low-risk
70914,0,0,0,0,low-risk
70923,11,130,211,352,high-risk
70926,0,0,0,0,low-risk
70932,0,0,0,0,low-risk
70939,12,101,122,235,medium-low-risk
70965,27,117,149,293,medium-high-risk
70969,12,127,206,345,high-risk
70975,27,99,218,344,high-risk
70982,15,146,231,392,high-risk
70985,12,166,217,395,high-risk
70993,12,150,180,342,high-risk
71000,12,102,127,241,medium-low-risk
71001,13,134,153,300,medium-high-risk
71006,12,162,191,365,high-risk
71007,42,128,189,359,high-risk
71008,54,149,239,442,high-risk
71010,0,0,0,0,low-risk
71011,12,113,178,303,medium-high-risk
71015,15,144,228,387,high-risk
71028,0,0,0,0,low-risk
71037,12,138,190,340,high-risk
7104,33,125,186,344,high-risk
71049,26,198,221,445,high-risk
71055,0,0,0,0,low-risk
71056,12,137,164,313,medium-high-risk
71064,0,0,0,0,low-risk
71084,0,0,0,0,low-risk
71104,21,122,164,307,medium-high-risk
71107,20,101,161,282,medium-high-risk
71118,0,0,0,0,low-risk
71131,0,0,0,0,low-risk
71132,32,150,217,399,high-risk
71138,0,0,0,0,low-risk
71149,0,0,0,0,low-risk
71150,12,161,205,378,high-risk
71156,23,110,207,340,high-risk
71159,19,94,134,247,medium-high-risk
7118,0,0,0,0,low-risk
71190,49,157,191,397,high-risk
71199,16,86,131,233,medium-low-risk
7120,34,137,199,370,high-risk
71201,12,123,167,302,medium-high-risk
71202,22,120,189,331,high-risk
71204,12,171,264,447,high-risk
71234,33,122,166,321,medium-high-risk
71249,0,0,0,0,low-risk
71252,12,143,97,252,medium-high-risk
71257,12,139,170,321,medium-high-risk
71263,0,0,0,0,low-risk
71271,0,0,0,0,low-risk
71282,32,136,188,356,high-risk
71287,0,0,0,0,low-risk
71288,14,88,132,234,medium-low-risk
7129,13,131,174,318,medium-high-risk
71290,0,0,0,0,low-risk
71292,0,0,0,0,low-risk
71296,13,120,154,287,medium-high-risk
71314,0,0,0,0,low-risk
71317,22,126,148,296,medium-high-risk
71327,29,145,223,397,high-risk
7134,29,155,193,377,high-risk
71344,0,0,0,0,low-risk
71349,0,0,0,0,low-risk
71355,0,0,0,0,low-risk
71357,0,0,0,0,low-risk
71368,0,0,0,0,low-risk
7138,0,0,0,0,low-risk
71401,0,0,0,0,low-risk
71412,12,133,176,321,medium-high-risk
71413,0,0,0,0,low-risk
71415,0,0,0,0,low-risk
71416,12,116,157,285,medium-high-risk
7142,0,0,0,0,low-risk
7143,14,79,110,203,medium-low-risk
71431,12,122,153,287,medium-high-risk
71442,0,0,0,0,low-risk
71445,0,0,0,0,low-risk
71454,0,0,0,0,low-risk
71467,28,155,189,372,high-risk
71469,44,130,215,389,high-risk
71471,0,0,0,0,low-risk
71489,0,0,0,0,low-risk
71493,44,143,215,402,high-risk
71496,13,74,109,196,medium-low-risk
71499,12,137,171,320,medium-high-risk
7150,31,111,162,304,medium-high-risk
71520,12,115,166,293,medium-high-risk
71531,12,118,134,264,medium-high-risk
71533,0,0,0,0,low-risk
71540,33,126,172,331,high-risk
71541,15,104,163,282,medium-high-risk
71546,18,116,161,295,medium-high-risk
7155,0,0,0,0,low-risk
71556,12,126,144,282,medium-high-risk
71564,12,120,91,223,medium-low-risk
71571,15,144,186,345,high-risk
71574,0,0,0,0,low-risk
71575,0,0,0,0,low-risk
71607,21,138,181,340,high-risk
71625,12,130,164,306,medium-high-risk
71627,17,166,205,388,high-risk
71631,12,108,150,270,medium-high-risk
71632,0,0,0,0,low-risk
71633,14,110,148,272,medium-high-risk
71642,12,109,155,276,medium-high-risk
71647,12,135,158,305,medium-high-risk
71651,19,114,172,305,medium-high-risk
71666,0,0,0,0,low-risk
7167,0,0,0,0,low-risk
71670,18,123,173,314,medium-high-risk
71683,40,134,184,358,high-risk
71684,12,120,160,292,medium-high-risk
71690,12,137,164,313,medium-high-risk
71696,12,184,218,414,high-risk
71699,27,116,151,294,medium-high-risk
7170,26,124,186,336,high-risk
71710,12,127,133,272,medium-high-risk
71712,26,118,150,294,medium-high-risk
71721,0,0,0,0,low-risk
71725,0,0,0,0,low-risk
71729,30,110,152,292,medium-high-risk
71740,12,115,169,296,medium-high-risk
71748,0,0,0,0,low-risk
71750,0,0,0,0,low-risk
71751,12,131,227,370,high-risk
71752,13,158,239,410,high-risk
71755,0,0,0,0,low-risk
71760,16,179,327,522,high-risk
71763,12,124,143,279,medium-high-risk
71788,12,96,107,215,medium-low-risk
71804,11,82,149,242,medium-low-risk
71805,12,114,155,281,medium-high-risk
71809,12,168,209,389,high-risk
71812,12,109,151,272,medium-high-risk
71814,12,110,140,262,medium-high-risk
71817,22,196,251,469,high-risk
71819,0,0,0,0,low-risk
71821,15,105,151,271,medium-high-risk
71826,0,0,0,0,low-risk
71827,25,119,176,320,medium-high-risk
71837,21,154,224,399,high-risk
71839,0,0,0,0,low-risk
71841,18,126,169,313,medium-high-risk
71849,0,0,0,0,low-risk
71855,0,0,0,0,low-risk
71859,33,158,245,436,high-risk
71865,0,0,0,0,low-risk
71887,0,0,0,0,low-risk
71889,0,0,0,0,low-risk
71899,25,211,219,455,high-risk
71909,12,120,230,362,high-risk
71915,0,0,0,0,low-risk
7192,29,148,206,383,high-risk
71920,21,122,172,315,medium-high-risk
71923,0,0,0,0,low-risk
71924,0,0,0,0,low-risk
71925,0,0,0,0,low-risk
71928,12,110,136,258,medium-high-risk
71937,0,0,0,0,low-risk
71939,24,140,187,351,high-risk
71940,0,0,0,0,low-risk
7196,0,0,0,0,low-risk
71962,0,0,0,0,low-risk
71963,0,0,0,0,low-risk
71986,0,0,0,0,low-risk
71988,18,187,222,427,high-risk
7199,0,0,0,0,low-risk
71991,17,149,192,358,high-risk
72007,0,0,0,0,low-risk
7201,26,115,168,309,medium-high-risk
72030,0,0,0,0,low-risk
72034,12,143,153,308,medium-high-risk
72042,0,0,0,0,low-risk
72043,26,125,154,305,medium-high-risk
72047,0,0,0,0,low-risk
72055,18,92,116,226,medium-low-risk
72059,0,0,0,0,low-risk
72064,0,0,0,0,low-risk
72066,49,153,202,404,high-risk
72075,12,128,327,467,high-risk
72096,0,0,0,0,low-risk
7210,0,0,0,0,low-risk
72101,0,0,0,0,low-risk
72112,12,89,112,213,medium-low-risk
72121,12,135,172,319,medium-high-risk
72124,0,0,0,0,low-risk
72130,0,0,0,0,low-risk
72132,41,100,189,330,high-risk
72137,12,121,191,324,medium-high-risk
7214,12,108,177,297,medium-high-risk
72151,12,138,125,275,medium-high-risk
72160,0,0,0,0,low-risk
72163,0,0,0,0,low-risk
72164,18,157,228,403,high-risk
72166,34,175,240,449,high-risk
72167,18,91,120,229,medium-low-risk
72174,12,92,130,234,medium-low-risk
72182,12,130,159,301,medium-high-risk
72184,0,0,0,0,low-risk
72198,26,125,182,333,high-risk
72206,12,132,204,348,high-risk
72221,0,0,0,0,low-risk
72226,44,141,269,454,high-risk
72234,0,0,0,0,low-risk
72236,0,0,0,0,low-risk
7224,22,133,171,326,medium-high-risk
72248,20,119,123,262,medium-high-risk
72253,12,115,145,272,medium-high-risk
72255,0,0,0,0,low-risk
72256,20,119,171,310,medium-high-risk
72267,0,0,0,0,low-risk
72272,13,132,209,354,high-risk
72283,12,239,263,514,high-risk
72289,0,0,0,0,low-risk
72295,12,125,167,304,medium-high-risk
72301,17,74,160,251,medium-high-risk
72302,12,71,91,174,medium-low-risk
72306,12,139,190,341,high-risk
7231,0,0,0,0,low-risk
72321,0,0,0,0,low-risk
72323,12,76,126,214,medium-low-risk
72327,17,177,244,438,high-risk
7233,0,0,0,0,low-risk
7234,12,149,278,439,high-risk
72347,16,93,152,261,medium-high-risk
7235,15,135,179,329,medium-high-risk
72351,0,0,0,0,low-risk
72352,13,133,179,325,medium-high-risk
72354,0,0,0,0,low-risk
72368,0,0,0,0,low-risk
72370,20,137,190,347,high-risk
72374,12,124,140,276,medium-high-risk
72378,13,83,131,227,medium-low-risk
7239,15,68,112,195,medium-low-risk
72402,0,0,0,0,low-risk
72424,0,0,0,0,low-risk
72438,28,112,175,315,medium-high-risk
72450,0,0,0,0,low-risk
7246,12,129,184,325,medium-high-risk
72461,0,0,0,0,low-risk
72470,12,148,159,319,medium-high-risk
72473,17,142,191,350,high-risk
7248,22,102,224,348,high-risk
72491,12,106,134,252,medium-high-risk
72514,0,0,0,0,low-risk
72517,0,0,0,0,low-risk
72532,12,86,101,199,medium-low-risk
72536,0,0,0,0,low-risk
72541,12,109,138,259,medium-high-risk
72568,29,112,157,298,medium-high-risk
7257,12,113,166,291,medium-high-risk
72576,12,137,169,318,medium-high-risk
72581,37,95,150,282,medium-high-risk
72582,0,0,0,0,low-risk
72583,0,0,0,0,low-risk
72586,0,0,0,0,low-risk
72587,13,109,168,290,medium-high-risk
72591,0,0,0,0,low-risk
72595,0,0,0,0,low-risk
72605,0,0,0,0,low-risk
72614,12,116,154,282,medium-high-risk
72628,0,0,0,0,low-risk
72646,48,156,237,441,high-risk
72647,20,124,159,303,medium-high-risk
72654,24,127,233,384,high-risk
72657,28,141,191,360,high-risk
72662,15,128,171,314,medium-high-risk
72679,0,0,0,0,low-risk
72681,0,0,0,0,low-risk
72682,18,127,187,332,high-risk
72683,0,0,0,0,low-risk
7269,12,103,139,254,medium-high-risk
72700,12,107,138,257,medium-high-risk
72704,30,130,173,333,high-risk
72706,0,0,0,0,low-risk
72708,12,101,232,345,high-risk
72714,0,0,0,0,low-risk
7272,12,118,172,302,medium-high-risk
72720,12,129,159,300,medium-high-risk
72722,0,0,0,0,low-risk
72723,12,122,152,286,medium-high-risk
72725,12,92,131,235,medium-low-risk
72731,0,0,0,0,low-risk
72745,15,159,194,368,high-risk
72750,0,0,0,0,low-risk
72754,13,147,127,287,medium-high-risk
72758,12,224,267,503,high-risk
72765,31,168,213,412,high-risk
72766,34,157,177,368,high-risk
72770,0,0,0,0,low-risk
72773,0,0,0,0,low-risk
72775,16,86,225,327,medium-high-risk
72776,0,0,0,0,low-risk
72785,0,0,0,0,low-risk
72789,12,117,153,282,medium-high-risk
72796,0,0,0,0,low-risk
72810,0,0,0,0,low-risk
72814,0,0,0,0,low-risk
72818,12,120,158,290,medium-high-risk
72831,20,97,157,274,medium-high-risk
72845,0,0,0,0,low-risk
72848,0,0,0,0,low-risk
72855,0,0,0,0,low-risk
72859,0,0,0,0,low-risk
72881,15,114,181,310,medium-high-risk
72886,0,0,0,0,low-risk
72888,15,128,176,319,medium-high-risk
72895,0,0,0,0,low-risk
7290,0,0,0,0,low-risk
72900,17,72,105,194,medium-low-risk
72901,0,0,0,0,low-risk
72909,12,123,157,292,medium-high-risk
7291,0,0,0,0,low-risk
72912,0,0,0,0,low-risk
72919,15,128,184,327,medium-high-risk
7292,20,151,201,372,high-risk
72920,13,151,201,365,high-risk
7293,29,102,150,281,medium-high-risk
72931,12,133,148,293,medium-high-risk
72932,0,0,0,0,low-risk
72945,33,155,199,387,high-risk
72946,12,56,90,158,medium-low-risk
72951,12,118,141,271,medium-high-risk
72954,12,116,157,285,medium-high-risk
7296,21,90,164,275,medium-high-risk
72960,12,159,189,360,high-risk
72966,12,124,131,267,medium-high-risk
72970,0,0,0,0,low-risk
72984,19,171,205,395,high-risk
72995,12,166,203,381,high-risk
72999,0,0,0,0,low-risk
7300,43,165,191,399,high-risk
7301,19,135,176,330,high-risk
73010,0,0,0,0,low-risk
73011,13,131,221,365,high-risk
73017,12,180,243,435,high-risk
73020,0,0,0,0,low-risk
73024,0,0,0,0,low-risk
73027,12,117,79,208,medium-low-risk
73029,12,95,147,254,medium-high-risk
7303,0,0,0,0,low-risk
73031,20,131,211,362,high-risk
73036,0,0,0,0,low-risk
73043,0,0,0,0,low-risk
73057,0,0,0,0,low-risk
73065,0,0,0,0,low-risk
73068,23,89,150,262,medium-high-risk
73073,0,0,0,0,low-risk
73077,12,159,211,382,high-risk
73082,0,0,0,0,low-risk
73092,22,129,180,331,high-risk
73097,0,0,0,0,low-risk
7310,54,114,312,480,high-risk
73113,0,0,0,0,low-risk
7312,13,131,217,361,high-risk
73128,0,0,0,0,low-risk
73130,0,0,0,0,low-risk
73141,53,148,239,440,high-risk
73142,15,88,127,230,medium-low-risk
73146,12,89,130,231,medium-low-risk
73155,12,138,166,316,medium-high-risk
7317,12,98,166,276,medium-high-risk
73171,12,118,195,325,medium-high-risk
7318,12,139,172,323,medium-high-risk
73183,0,0,0,0,low-risk
73190,0,0,0,0,low-risk
73194,0,0,0,0,low-risk
73196,30,184,283,497,high-risk
73203,0,0,0,0,low-risk
73205,32,120,171,323,medium-high-risk
73219,30,121,154,305,medium-high-risk
73234,12,124,173,309,medium-high-risk
73244,0,0,0,0,low-risk
73251,0,0,0,0,low-risk
73281,12,84,119,215,medium-low-risk
73285,12,86,87,185,medium-low-risk
73292,19,168,289,476,high-risk
73293,12,128,172,312,medium-high-risk
7330,39,156,201,396,high-risk
73305,0,0,0,0,low-risk
73307,0,0,0,0,low-risk
73312,0,0,0,0,low-risk
73340,0,0,0,0,low-risk
73344,12,166,249,427,high-risk
73353,12,90,110,212,medium-low-risk
73355,0,0,0,0,low-risk
73356,0,0,0,0,low-risk
73362,12,124,172,308,medium-high-risk
7337,12,96,129,237,medium-low-risk
73371,0,0,0,0,low-risk
73373,0,0,0,0,low-risk
73375,0,0,0,0,low-risk
73378,0,0,0,0,low-risk
73387,0,0,0,0,low-risk
73392,0,0,0,0,low-risk
73393,12,136,114,262,medium-high-risk
73395,38,134,151,323,medium-high-risk
73400,0,0,0,0,low-risk
73405,31,187,270,488,high-risk
73409,25,106,129,260,medium-high-risk
73416,14,113,192,319,medium-high-risk
7343,0,0,0,0,low-risk
73435,12,131,144,287,medium-high-risk
73449,0,0,0,0,low-risk
73456,12,106,140,258,medium-high-risk
73466,0,0,0,0,low-risk
73468,12,102,137,251,medium-high-risk
73474,12,104,130,246,medium-high-risk
73476,0,0,0,0,low-risk
73478,21,165,213,399,high-risk
73487,12,117,137,266,medium-high-risk
73489,0,0,0,0,low-risk
73495,0,0,0,0,low-risk
7350,0,0,0,0,low-risk
73506,0,0,0,0,low-risk
73513,31,129,174,334,high-risk
73521,33,98,268,399,high-risk
73525,0,0,0,0,low-risk
73526,16,122,165,303,medium-high-risk
73533,0,0,0,0,low-risk
73534,0,0,0,0,low-risk
73542,0,0,0,0,low-risk
73545,15,103,160,278,medium-high-risk
73562,29,137,181,347,high-risk
73571,14,129,221,364,high-risk
73575,12,155,194,361,high-risk
73584,0,0,0,0,low-risk
73585,0,0,0,0,low-risk
73591,17,243,202,462,high-risk
73599,20,115,164,299,medium-high-risk
7360,0,0,0,0,low-risk
73608,46,137,195,378,high-risk
73612,12,149,226,387,high-risk
73615,12,125,136,273,medium-high-risk
73639,12,98,132,242,medium-low-risk
73666,0,0,0,0,low-risk
73668,12,101,155,268,medium-high-risk
73672,12,119,159,290,medium-high-risk
73683,0,0,0,0,low-risk
73684,13,97,136,246,medium-high-risk
73689,0,0,0,0,low-risk
7369,15,150,193,358,high-risk
73708,12,137,168,317,medium-high-risk
73709,0,0,0,0,low-risk
73722,0,0,0,0,low-risk
7373,37,157,217,411,high-risk
73735,13,180,207,400,high-risk
73744,12,167,215,394,high-risk
73770,0,0,0,0,low-risk
73780,0,0,0,0,low-risk
73785,0,0,0,0,low-risk
73786,0,0,0,0,low-risk
73788,14,125,146,285,medium-high-risk
73795,0,0,0,0,low-risk
73810,0,0,0,0,low-risk
73821,12,99,129,240,medium-low-risk
73832,0,0,0,0,low-risk
73837,12,110,158,280,medium-high-risk
73842,12,114,149,275,medium-high-risk
73846,12,146,170,328,medium-high-risk
73848,15,68,105,188,medium-low-risk
73855,0,0,0,0,low-risk
73858,17,129,184,330,high-risk
73873,0,0,0,0,low-risk
73878,12,123,201,336,high-risk
73880,13,95,165,273,medium-high-risk
7389,12,120,193,325,medium-high-risk
73891,33,128,155,316,medium-high-risk
73893,39,139,263,441,high-risk
73895,12,105,124,241,medium-low-risk
73907,12,109,185,306,medium-high-risk
73908,12,119,139,270,medium-high-risk
73922,33,84,159,276,medium-high-risk
73944,20,104,159,283,medium-high-risk
73947,14,109,158,281,medium-high-risk
7395,28,168,210,406,high-risk
73951,13,136,171,320,medium-high-risk
73953,28,105,161,294,medium-high-risk
73959,0,0,0,0,low-risk
7396,21,162,231,414,high-risk
73960,22,133,202,357,high-risk
73963,0,0,0,0,low-risk
73968,0,0,0,0,low-risk
7397,0,0,0,0,low-risk
73971,0,0,0,0,low-risk
7398,0,0,0,0,low-risk
73989,0,0,0,0,low-risk
73994,23,123,161,307,medium-high-risk
74020,0,0,0,0,low-risk
74027,16,165,271,452,high-risk
74045,12,129,163,304,medium-high-risk
74050,0,0,0,0,low-risk
74051,12,84,134,230,medium-low-risk
74054,35,110,144,289,medium-high-risk
74062,0,0,0,0,low-risk
74069,0,0,0,0,low-risk
74070,0,0,0,0,low-risk
74075,12,98,134,244,medium-low-risk
74077,12,138,162,312,medium-high-risk
74081,12,108,159,279,medium-high-risk
74092,12,85,154,251,medium-high-risk
74108,0,0,0,0,low-risk
7411,0,0,0,0,low-risk
74119,17,177,211,405,high-risk
74123,19,88,128,235,medium-low-risk
74127,20,115,212,347,high-risk
74130,12,152,190,354,high-risk
74134,12,109,117,238,medium-low-risk
74136,0,0,0,0,low-risk
74137,0,0,0,0,low-risk
74148,0,0,0,0,low-risk
74151,28,123,155,306,medium-high-risk
74155,12,126,115,253,medium-high-risk
74169,12,108,134,254,medium-high-risk
7417,12,125,152,289,medium-high-risk
74173,17,117,209,343,high-risk
74180,20,107,151,278,medium-high-risk
74182,17,200,237,454,high-risk
74183,0,0,0,0,low-risk
74186,0,0,0,0,low-risk
7421,12,105,153,270,medium-high-risk
74217,0,0,0,0,low-risk
74218,12,117,147,276,medium-high-risk
74224,0,0,0,0,low-risk
74226,0,0,0,0,low-risk
74235,0,0,0,0,low-risk
74240,12,145,177,334,high-risk
74244,0,0,0,0,low-risk
74253,0,0,0,0,low-risk
74265,12,161,231,404,high-risk
74275,26,99,125,250,medium-high-risk
7428,0,0,0,0,low-risk
74280,12,128,154,294,medium-high-risk
74285,13,90,128,231,medium-low-risk
74286,0,0,0,0,low-risk
74293,0,0,0,0,low-risk
74304,0,0,0,0,low-risk
74305,0,0,0,0,low-risk
74306,0,0,0,0,low-risk
74308,12,107,136,255,medium-high-risk
74312,12,124,112,248,medium-high-risk
74313,27,71,104,202,medium-low-risk
74337,13,117,202,332,high-risk
74339,12,98,136,246,medium-high-risk
74341,27,118,208,353,high-risk
74346,40,151,231,422,high-risk
74349,17,100,173,290,medium-high-risk
74361,12,158,211,381,high-risk
7437,0,0,0,0,low-risk
74374,0,0,0,0,low-risk
74378,31,114,187,332,high-risk
74381,0,0,0,0,low-risk
74388,23,102,145,270,medium-high-risk
74393,19,96,123,238,medium-low-risk
74400,13,159,202,374,high-risk
74403,0,0,0,0,low-risk
74408,12,158,196,366,high-risk
7442,0,0,0,0,low-risk
74438,12,162,194,368,high-risk
7444,0,0,0,0,low-risk
74446,20,101,148,269,medium-high-risk
74448,47,228,403,678,high-risk
7445,0,0,0,0,low-risk
74456,12,234,196,442,high-risk
7446,12,137,175,324,medium-high-risk
74460,0,0,0,0,low-risk
74462,0,0,0,0,low-risk
74465,0,0,0,0,low-risk
74469,12,117,162,291,medium-high-risk
74472,0,0,0,0,low-risk
74483,24,110,168,302,medium-high-risk
74488,0,0,0,0,low-risk
74499,0,0,0,0,low-risk
74519,12,64,129,205,medium-low-risk
74520,12,116,144,272,medium-high-risk
74524,0,0,0,0,low-risk
7453,12,137,148,297,medium-high-risk
74531,12,99,139,250,medium-high-risk
74534,46,163,195,404,high-risk
74536,12,149,272,433,high-risk
74545,0,0,0,0,low-risk
74549,0,0,0,0,low-risk
7455,0,0,0,0,low-risk
74550,12,169,212,393,high-risk
74564,19,71,107,197,medium-low-risk
74572,0,0,0,0,low-risk
74577,12,119,138,269,medium-high-risk
74596,0,0,0,0,low-risk
74600,12,91,152,255,medium-high-risk
74601,0,0,0,0,low-risk
74604,15,117,163,295,medium-high-risk
74612,0,0,0,0,low-risk
74619,12,150,174,336,high-risk
74621,14,114,250,378,high-risk
74627,12,126,146,284,medium-high-risk
74628,0,0,0,0,low-risk
74632,12,109,119,240,medium-low-risk
74633,0,0,0,0,low-risk
74646,28,144,177,349,high-risk
74654,0,0,0,0,low-risk
74676,12,140,172,324,medium-high-risk
74677,12,83,129,224,medium-low-risk
74694,12,144,175,331,high-risk
74697,12,148,223,383,high-risk
7470,0,0,0,0,low-risk
74700,17,164,203,384,high-risk
74702,0,0,0,0,low-risk
74704,0,0,0,0,low-risk
74711,0,0,0,0,low-risk
74718,28,140,167,335,high-risk
7472,40,175,213,428,high-risk
74722,0,0,0,0,low-risk
74723,0,0,0,0,low-risk
74725,12,77,92,181,medium-low-risk
74727,0,0,0,0,low-risk
74739,16,141,245,402,high-risk
7475,14,155,240,409,high-risk
74750,0,0,0,0,low-risk
74759,0,0,0,0,low-risk
74765,0,0,0,0,low-risk
74767,12,94,108,214,medium-low-risk
74784,0,0,0,0,low-risk
74794,0,0,0,0,low-risk
74797,20,146,196,362,high-risk
74804,12,122,167,301,medium-high-risk
74805,0,0,0,0,low-risk
74807,0,0,0,0,low-risk
74815,0,0,0,0,low-risk
74817,0,0,0,0,low-risk
74831,29,124,159,312,medium-high-risk
74841,29,161,205,395,high-risk
74842,0,0,0,0,low-risk
74846,0,0,0,0,low-risk
74847,12,112,108,232,medium-low-risk
7485,12,132,212,356,high-risk
74851,12,129,162,303,medium-high-risk
74853,0,0,0,0,low-risk
74856,0,0,0,0,low-risk
74859,0,0,0,0,low-risk
74861,0,0,0,0,low-risk
74863,14,160,281,455,high-risk
74869,21,136,193,350,high-risk
74876,48,127,222,397,high-risk
74881,12,119,139,270,medium-high-risk
74882,12,79,120,211,medium-low-risk
74886,0,0,0,0,low-risk
74909,19,83,159,261,medium-high-risk
74910,0,0,0,0,low-risk
74918,0,0,0,0,low-risk
74922,30,148,199,377,high-risk
74923,0,0,0,0,low-risk
74936,0,0,0,0,low-risk
74941,0,0,0,0,low-risk
74956,0,0,0,0,low-risk
74958,0,0,0,0,low-risk
74970,0,0,0,0,low-risk
74973,12,140,142,294,medium-high-risk
74975,0,0,0,0,low-risk
74977,0,0,0,0,low-risk
74979,0,0,0,0,low-risk
74989,0,0,0,0,low-risk
74994,0,0,0,0,low-risk
75016,12,76,105,193,medium-low-risk
75021,0,0,0,0,low-risk
75031,31,115,151,297,medium-high-risk
75041,13,112,169,294,medium-high-risk
75043,24,218,159,401,high-risk
75049,24,113,178,315,medium-high-risk
75050,0,0,0,0,low-risk
75056,0,0,0,0,low-risk
75061,0,0,0,0,low-risk
75074,0,0,0,0,low-risk
75079,12,104,128,244,medium-low-risk
75089,0,0,0,0,low-risk
75093,26,120,175,321,medium-high-risk
75108,14,142,231,387,high-risk
75114,12,84,125,221,medium-low-risk
75115,0,0,0,0,low-risk
75125,0,0,0,0,low-risk
75133,0,0,0,0,low-risk
75135,0,0,0,0,low-risk
75145,0,0,0,0,low-risk
75147,25,105,159,289,medium-high-risk
75152,0,0,0,0,low-risk
75163,12,103,123,238,medium-low-risk
75170,12,151,227,390,high-risk
75181,17,161,215,393,high-risk
75182,13,152,213,378,high-risk
7519,0,0,0,0,low-risk
75197,0,0,0,0,low-risk
75199,0,0,0,0,low-risk
75201,12,132,190,334,high-risk
75207,12,112,140,264,medium-high-risk
75211,0,0,0,0,low-risk
75213,12,112,135,259,medium-high-risk
75219,18,72,131,221,medium-low-risk
75220,53,164,212,429,high-risk
7523,0,0,0,0,low-risk
75231,12,108,154,274,medium-high-risk
75239,17,120,173,310,medium-high-risk
75248,0,0,0,0,low-risk
75250,12,150,177,339,high-risk
75252,0,0,0,0,low-risk
75254,12,127,149,288,medium-high-risk
75259,0,0,0,0,low-risk
75262,0,0,0,0,low-risk
75264,12,103,135,250,medium-high-risk
7527,0,0,0,0,low-risk
75279,0,0,0,0,low-risk
7528,0,0,0,0,low-risk
75286,12,92,122,226,medium-low-risk
7530,0,0,0,0,low-risk
75303,0,0,0,0,low-risk
75305,23,220,295,538,high-risk
75319,12,134,190,336,high-risk
75338,12,181,190,383,high-risk
7534,22,154,191,367,high-risk
75344,0,0,0,0,low-risk
75345,12,118,160,290,medium-high-risk
75362,12,109,135,256,medium-high-risk
75369,31,116,184,331,high-risk
75374,12,178,213,403,high-risk
75376,39,121,214,374,high-risk
75378,0,0,0,0,low-risk
75379,24,159,194,377,high-risk
7538,12,146,193,351,high-risk
75381,12,59,74,145,medium-low-risk
7539,0,0,0,0,low-risk
75396,12,149,176,337,high-risk
7540,0,0,0,0,low-risk
75405,0,0,0,0,low-risk
75412,0,0,0,0,low-risk
75414,13,136,315,464,high-risk
75415,0,0,0,0,low-risk
75418,36,136,184,356,high-risk
75429,12,140,158,310,medium-high-risk
75435,13,103,154,270,medium-high-risk
75448,12,164,177,353,high-risk
75463,0,0,0,0,low-risk
75477,12,101,140,253,medium-high-risk
75495,0,0,0,0,low-risk
7550,12,174,223,409,high-risk
75501,13,150,291,454,high-risk
75503,0,0,0,0,low-risk
75508,15,138,187,340,high-risk
75519,0,0,0,0,low-risk
7552,0,0,0,0,low-risk
75532,0,0,0,0,low-risk
75537,12,145,177,334,high-risk
75539,25,125,182,332,high-risk
75547,21,193,257,471,high-risk
75552,12,165,196,373,high-risk
75566,37,123,162,322,medium-high-risk
75588,14,121,151,286,medium-high-risk
7559,0,0,0,0,low-risk
75600,12,133,216,361,high-risk
75603,12,119,151,282,medium-high-risk
75608,35,152,215,402,high-risk
75611,21,101,233,355,high-risk
75621,13,80,120,213,medium-low-risk
75629,0,0,0,0,low-risk
75633,61,169,324,554,high-risk
7564,0,0,0,0,low-risk
75661,26,145,171,342,high-risk
75662,13,148,200,361,high-risk
75665,12,141,117,270,medium-high-risk
75669,12,122,100,234,medium-low-risk
75675,0,0,0,0,low-risk
75677,0,0,0,0,low-risk
75682,17,129,169,315,medium-high-risk
75697,0,0,0,0,low-risk
75708,12,139,159,310,medium-high-risk
75709,0,0,0,0,low-risk
75711,0,0,0,0,low-risk
75713,0,0,0,0,low-risk
75715,17,186,234,437,high-risk
7572,14,122,169,305,medium-high-risk
75727,0,0,0,0,low-risk
75734,0,0,0,0,low-risk
75744,0,0,0,0,low-risk
75745,0,0,0,0,low-risk
75748,22,140,177,339,high-risk
75761,26,186,255,467,high-risk
75767,0,0,0,0,low-risk
75768,0,0,0,0,low-risk
75771,12,129,181,322,medium-high-risk
75772,28,106,185,319,medium-high-risk
75785,0,0,0,0,low-risk
75786,0,0,0,0,low-risk
75798,0,0,0,0,low-risk
75816,12,82,119,213,medium-low-risk
75817,0,0,0,0,low-risk
7582,12,122,158,292,medium-high-risk
75823,13,177,226,416,high-risk
75828,0,0,0,0,low-risk
75829,12,105,120,237,medium-low-risk
75832,0,0,0,0,low-risk
75833,12,115,131,258,medium-high-risk
75834,0,0,0,0,low-risk
75836,12,129,155,296,medium-high-risk
75841,12,82,119,213,medium-low-risk
75846,12,141,156,309,medium-high-risk
75853,0,0,0,0,low-risk
75857,13,181,222,416,high-risk
75862,34,143,184,361,high-risk
75866,0,0,0,0,low-risk
75868,12,178,209,399,high-risk
75873,0,0,0,0,low-risk
75876,0,0,0,0,low-risk
75881,32,144,191,367,high-risk
75893,13,120,154,287,medium-high-risk
75897,20,116,154,290,medium-high-risk
75904,12,129,142,283,medium-high-risk
75908,17,111,149,277,medium-high-risk
75924,12,90,129,231,medium-low-risk
75941,18,90,134,242,medium-low-risk
75944,12,149,180,341,high-risk
75956,0,0,0,0,low-risk
75974,0,0,0,0,low-risk
75978,27,106,130,263,medium-high-risk
75998,0,0,0,0,low-risk
76002,30,92,144,266,medium-high-risk
7601,22,137,185,344,high-risk
76011,0,0,0,0,low-risk
76022,12,153,182,347,high-risk
76037,18,82,126,226,medium-low-risk
76040,15,117,167,299,medium-high-risk
76062,12,146,158,316,medium-high-risk
76065,12,113,146,271,medium-high-risk
76071,0,0,0,0,low-risk
76086,12,140,216,368,high-risk
76093,14,124,158,296,medium-high-risk
76098,12,125,185,322,medium-high-risk
76101,30,123,166,319,medium-high-risk
76105,25,108,160,293,medium-high-risk
76107,15,119,191,325,medium-high-risk
76112,12,149,176,337,high-risk
76119,0,0,0,0,low-risk
76121,0,0,0,0,low-risk
76124,0,0,0,0,low-risk
76131,12,116,151,279,medium-high-risk
76132,0,0,0,0,low-risk
76135,0,0,0,0,low-risk
76145,0,0,0,0,low-risk
76147,0,0,0,0,low-risk
76149,12,121,162,295,medium-high-risk
76152,12,128,141,281,medium-high-risk
76167,0,0,0,0,low-risk
76169,0,0,0,0,low-risk
76191,0,0,0,0,low-risk
76204,0,0,0,0,low-risk
76208,0,0,0,0,low-risk
76211,0,0,0,0,low-risk
7623,12,151,165,328,medium-high-risk
76235,12,103,122,237,medium-low-risk
76240,16,135,220,371,high-risk
76241,0,0,0,0,low-risk
76248,0,0,0,0,low-risk
76251,0,0,0,0,low-risk
76258,13,130,235,378,high-risk
76269,0,0,0,0,low-risk
76270,0,0,0,0,low-risk
76280,22,110,138,270,medium-high-risk
76287,17,105,191,313,medium-high-risk
76288,0,0,0,0,low-risk
7629,0,0,0,0,low-risk
76295,17,123,160,300,medium-high-risk
76297,0,0,0,0,low-risk
76308,0,0,0,0,low-risk
76313,12,98,143,253,medium-high-risk
76328,12,145,207,364,high-risk
76338,0,0,0,0,low-risk
76342,0,0,0,0,low-risk
76343,0,0,0,0,low-risk
76346,0,0,0,0,low-risk
76369,12,121,149,282,medium-high-risk
7637,11,121,149,281,medium-high-risk
76370,29,162,244,435,high-risk
76393,12,132,158,302,medium-high-risk
76394,34,133,174,341,high-risk
76402,12,90,130,232,medium-low-risk
76410,18,110,263,391,high-risk
76416,0,0,0,0,low-risk
76420,0,0,0,0,low-risk
76426,16,100,149,265,medium-high-risk
76444,0,0,0,0,low-risk
76448,0,0,0,0,low-risk
76456,25,121,287,433,high-risk
76468,12,66,110,188,medium-low-risk
76470,0,0,0,0,low-risk
76490,0,0,0,0,low-risk
76492,12,161,266,439,high-risk
76498,12,124,157,293,medium-high-risk
76499,0,0,0,0,low-risk
76500,0,0,0,0,low-risk
76501,0,0,0,0,low-risk
76511,31,130,271,432,high-risk
76527,36,112,162,310,medium-high-risk
76546,12,152,198,362,high-risk
76564,33,111,133,277,medium-high-risk
76569,12,96,133,241,medium-low-risk
76581,13,123,161,297,medium-high-risk
76584,12,117,156,285,medium-high-risk
76588,13,227,292,532,high-risk
7659,12,161,204,377,high-risk
76590,12,84,139,235,medium-low-risk
76604,22,167,277,466,high-risk
76607,12,137,162,311,medium-high-risk
7661,0,0,0,0,low-risk
76612,0,0,0,0,low-risk
76624,0,0,0,0,low-risk
76635,48,136,195,379,high-risk
7664,18,86,108,212,medium-low-risk
76648,13,129,170,312,medium-high-risk
76654,16,124,149,289,medium-high-risk
76659,21,115,174,310,medium-high-risk
76665,12,103,129,244,medium-low-risk
76681,0,0,0,0,low-risk
76684,0,0,0,0,low-risk
76687,12,106,123,241,medium-low-risk
76690,0,0,0,0,low-risk
76697,16,108,158,282,medium-high-risk
76710,12,149,231,392,high-risk
76712,0,0,0,0,low-risk
7672,14,103,159,276,medium-high-risk
76729,0,0,0,0,low-risk
76734,12,100,152,264,medium-high-risk
76736,0,0,0,0,low-risk
76746,12,122,139,273,medium-high-risk
76747,0,0,0,0,low-risk
76757,53,161,225,439,high-risk
76758,14,124,190,328,medium-high-risk
76760,12,115,159,286,medium-high-risk
76765,0,0,0,0,low-risk
76773,0,0,0,0,low-risk
76786,27,156,213,396,high-risk
7679,0,0,0,0,low-risk
76799,0,0,0,0,low-risk
7680,18,111,146,275,medium-high-risk
76804,12,118,190,320,medium-high-risk
76808,12,108,157,277,medium-high-risk
76810,0,0,0,0,low-risk
76811,21,120,153,294,medium-high-risk
76812,12,137,170,319,medium-high-risk
7682,0,0,0,0,low-risk
76824,43,188,241,472,high-risk
76828,0,0,0,0,low-risk
76833,0,0,0,0,low-risk
76839,12,87,133,232,medium-low-risk
76847,0,0,0,0,low-risk
76856,12,151,236,399,high-risk
76857,0,0,0,0,low-risk
7686,12,81,104,197,medium-low-risk
76872,30,134,169,333,high-risk
76874,0,0,0,0,low-risk
76891,0,0,0,0,low-risk
76898,12,104,118,234,medium-low-risk
7690,12,150,166,328,medium-high-risk
76906,12,125,171,308,medium-high-risk
7692,18,139,168,325,medium-high-risk
76922,32,120,192,344,high-risk
76923,0,0,0,0,low-risk
76924,41,163,207,411,high-risk
76928,0,0,0,0,low-risk
76930,12,143,154,309,medium-high-risk
76933,21,155,228,404,high-risk
7694,12,149,193,354,high-risk
76941,32,165,176,373,high-risk
76946,14,154,213,381,high-risk
76947,27,140,164,331,high-risk
76950,32,107,182,321,medium-high-risk
76951,0,0,0,0,low-risk
76957,0,0,0,0,low-risk
76974,13,157,231,401,high-risk
76976,0,0,0,0,low-risk
76979,0,0,0,0,low-risk
7698,0,0,0,0,low-risk
76990,0,0,0,0,low-risk
76993,12,113,83,208,medium-low-risk
77003,18,155,197,370,high-risk
77035,0,0,0,0,low-risk
77038,24,143,205,372,high-risk
77040,0,0,0,0,low-risk
77045,0,0,0,0,low-risk
77063,12,136,183,331,high-risk
77064,12,76,118,206,medium-low-risk
77068,0,0,0,0,low-risk
77071,41,121,171,333,high-risk
77084,16,104,144,264,medium-high-risk
77120,12,163,198,373,high-risk
77126,17,119,159,295,medium-high-risk
77136,30,141,426,597,high-risk
77147,0,0,0,0,low-risk
77148,0,0,0,0,low-risk
77159,12,135,147,294,medium-high-risk
77162,0,0,0,0,low-risk
77167,42,155,280,477,high-risk
77171,34,122,163,319,medium-high-risk
77173,12,165,227,404,high-risk
77180,0,0,0,0,low-risk
77183,18,106,130,254,medium-high-risk
77195,12,72,108,192,medium-low-risk
77197,0,0,0,0,low-risk
77214,25,212,243,480,high-risk
77217,12,146,176,334,high-risk
77222,24,85,130,239,medium-low-risk
77230,20,123,233,376,high-risk
77237,15,111,142,268,medium-high-risk
77243,12,156,180,348,high-risk
77249,0,0,0,0,low-risk
77253,22,137,163,322,medium-high-risk
77260,0,0,0,0,low-risk
77273,12,109,132,253,medium-high-risk
77297,0,0,0,0,low-risk
77301,12,112,158,282,medium-high-risk
77324,0,0,0,0,low-risk
7734,0,0,0,0,low-risk
77345,0,0,0,0,low-risk
77355,0,0,0,0,low-risk
77357,12,120,139,271,medium-high-risk
7736,0,0,0,0,low-risk
77363,12,120,166,298,medium-high-risk
77369,12,143,250,405,high-risk
77375,0,0,0,0,low-risk
77380,18,150,178,346,high-risk
77394,0,0,0,0,low-risk
77395,12,127,142,281,medium-high-risk
77400,33,195,252,480,high-risk
77405,0,0,0,0,low-risk
77407,16,95,135,246,medium-high-risk
77410,12,94,123,229,medium-low-risk
77423,0,0,0,0,low-risk
77435,0,0,0,0,low-risk
77446,12,138,162,312,medium-high-risk
77452,22,154,196,372,high-risk
77458,32,150,197,379,high-risk
7746,12,158,185,355,high-risk
77464,26,102,183,311,medium-high-risk
77470,0,0,0,0,low-risk
77476,24,142,176,342,high-risk
77479,12,92,109,213,medium-low-risk
77493,21,128,246,395,high-risk
77506,17,97,129,243,medium-low-risk
77512,12,148,186,346,high-risk
77514,37,93,135,265,medium-high-risk
7752,0,0,0,0,low-risk
77527,12,140,229,381,high-risk
77534,26,107,140,273,medium-high-risk
77537,0,0,0,0,low-risk
77556,0,0,0,0,low-risk
77557,12,80,109,201,medium-low-risk
77560,11,136,167,314,medium-high-risk
77576,0,0,0,0,low-risk
77584,12,147,306,465,high-risk
77606,0,0,0,0,low-risk
77620,11,168,191,370,high-risk
77624,0,0,0,0,low-risk
77638,12,112,135,259,medium-high-risk
7764,0,0,0,0,low-risk
77642,15,104,159,278,medium-high-risk
77656,12,154,189,355,high-risk
77660,0,0,0,0,low-risk
77663,0,0,0,0,low-risk
77669,23,128,168,319,medium-high-risk
77676,0,0,0,0,low-risk
77687,12,101,118,231,medium-low-risk
77698,0,0,0,0,low-risk
77699,12,146,202,360,high-risk
77710,0,0,0,0,low-risk
77724,0,0,0,0,low-risk
7773,0,0,0,0,low-risk
77732,0,0,0,0,low-risk
77738,0,0,0,0,low-risk
77753,12,94,111,217,medium-low-risk
77760,0,0,0,0,low-risk
77761,12,174,221,407,high-risk
77763,12,91,126,229,medium-low-risk
77764,0,0,0,0,low-risk
77775,0,0,0,0,low-risk
77784,0,0,0,0,low-risk
77787,12,123,141,276,medium-high-risk
77806,0,0,0,0,low-risk
77815,0,0,0,0,low-risk
77816,0,0,0,0,low-risk
77819,0,0,0,0,low-risk
7783,13,107,130,250,medium-high-risk
77832,12,109,128,249,medium-high-risk
77844,0,0,0,0,low-risk
77851,0,0,0,0,low-risk
77868,14,103,143,260,medium-high-risk
77875,0,0,0,0,low-risk
77901,0,0,0,0,low-risk
77908,0,0,0,0,low-risk
7791,12,151,196,359,high-risk
77911,0,0,0,0,low-risk
77913,31,147,194,372,high-risk
77922,12,120,151,283,medium-high-risk
77926,0,0,0,0,low-risk
77939,0,0,0,0,low-risk
77946,0,0,0,0,low-risk
77948,12,118,125,255,medium-high-risk
77951,0,0,0,0,low-risk
77957,0,0,0,0,low-risk
77966,0,0,0,0,low-risk
77974,12,130,222,364,high-risk
77984,0,0,0,0,low-risk
77989,0,0,0,0,low-risk
77993,12,151,167,330,high-risk
77995,0,0,0,0,low-risk
78000,13,163,200,376,high-risk
78007,0,0,0,0,low-risk
78017,12,201,162,375,high-risk
78023,0,0,0,0,low-risk
78033,21,183,244,448,high-risk
78042,0,0,0,0,low-risk
78049,62,162,203,427,high-risk
78055,12,135,157,304,medium-high-risk
78056,16,172,214,402,high-risk
78057,12,125,160,297,medium-high-risk
78059,0,0,0,0,low-risk
78062,18,165,233,416,high-risk
78067,32,169,221,422,high-risk
78077,0,0,0,0,low-risk
78078,19,131,177,327,medium-high-risk
78085,0,0,0,0,low-risk
7809,15,171,214,400,high-risk
78092,12,130,216,358,high-risk
78093,12,97,124,233,medium-low-risk
78094,0,0,0,0,low-risk
7810,12,132,155,299,medium-high-risk
78104,0,0,0,0,low-risk
78105,0,0,0,0,low-risk
78110,19,76,113,208,medium-low-risk
78115,40,129,200,369,high-risk
78116,21,124,169,314,medium-high-risk
78119,0,0,0,0,low-risk
78121,0,0,0,0,low-risk
78122,0,0,0,0,low-risk
78125,21,113,154,288,medium-high-risk
78137,52,152,239,443,high-risk
78140,24,133,192,349,high-risk
78142,0,0,0,0,low-risk
78147,0,0,0,0,low-risk
78176,0,0,0,0,low-risk
78177,11,99,129,239,medium-low-risk
78184,0,0,0,0,low-risk
78197,33,117,185,335,high-risk
78198,11,177,250,438,high-risk
7820,0,0,0,0,low-risk
78200,0,0,0,0,low-risk
78211,0,0,0,0,low-risk
78213,0,0,0,0,low-risk
78222,0,0,0,0,low-risk
78223,12,120,156,288,medium-high-risk
78224,33,135,196,364,high-risk
78228,0,0,0,0,low-risk
78244,0,0,0,0,low-risk
78253,22,100,133,255,medium-high-risk
78258,12,126,141,279,medium-high-risk
78259,0,0,0,0,low-risk
78272,0,0,0,0,low-risk
78273,12,111,140,263,medium-high-risk
78275,25,110,160,295,medium-high-risk
7828,0,0,0,0,low-risk
78290,0,0,0,0,low-risk
78306,13,110,154,277,medium-high-risk
7831,14,172,256,442,high-risk
78326,0,0,0,0,low-risk
78334,0,0,0,0,low-risk
78337,0,0,0,0,low-risk
78345,12,165,195,372,high-risk
78360,12,118,143,273,medium-high-risk
78365,0,0,0,0,low-risk
78380,27,125,173,325,medium-high-risk
78389,24,118,165,307,medium-high-risk
78401,33,139,180,352,high-risk
78403,0,0,0,0,low-risk
78414,12,121,170,303,medium-high-risk
78415,12,126,136,274,medium-high-risk
78418,12,114,210,336,high-risk
78419,47,163,219,429,high-risk
78422,12,155,187,354,high-risk
78423,53,165,206,424,high-risk
78426,0,0,0,0,low-risk
7843,12,121,163,296,medium-high-risk
78430,21,143,179,343,high-risk
78440,12,96,98,206,medium-low-risk
78445,40,146,217,403,high-risk
78453,12,80,113,205,medium-low-risk
78457,0,0,0,0,low-risk
78458,12,120,159,291,medium-high-risk
78462,0,0,0,0,low-risk
78465,0,0,0,0,low-risk
78468,12,137,92,241,medium-low-risk
78470,0,0,0,0,low-risk
78472,13,150,204,367,high-risk
78474,0,0,0,0,low-risk
78478,16,69,135,220,medium-low-risk
78482,28,119,152,299,medium-high-risk
78484,0,0,0,0,low-risk
78485,0,0,0,0,low-risk
78494,0,0,0,0,low-risk
7850,0,0,0,0,low-risk
78509,12,138,159,309,medium-high-risk
7851,18,167,244,429,high-risk
78511,0,0,0,0,low-risk
78514,0,0,0,0,low-risk
78525,0,0,0,0,low-risk
78526,0,0,0,0,low-risk
78529,0,0,0,0,low-risk
7853,11,146,194,351,high-risk
78533,16,176,246,438,high-risk
78547,0,0,0,0,low-risk
78548,16,132,166,314,medium-high-risk
78551,0,0,0,0,low-risk
78554,0,0,0,0,low-risk
7856,0,0,0,0,low-risk
78568,12,85,111,208,medium-low-risk
7857,12,127,223,362,high-risk
78571,0,0,0,0,low-risk
78576,26,92,143,261,medium-high-risk
78589,12,122,142,276,medium-high-risk
78603,12,89,90,191,medium-low-risk
78605,0,0,0,0,low-risk
78612,0,0,0,0,low-risk
78615,0,0,0,0,low-risk
78628,15,161,190,366,high-risk
78629,0,0,0,0,low-risk
78647,12,101,109,222,medium-low-risk
78652,12,137,231,380,high-risk
78663,0,0,0,0,low-risk
78668,32,106,157,295,medium-high-risk
78671,12,118,85,215,medium-low-risk
78673,16,90,117,223,medium-low-risk
78681,12,144,199,355,high-risk
78688,0,0,0,0,low-risk
78700,0,0,0,0,low-risk
78704,13,64,152,229,medium-low-risk
78719,12,104,167,283,medium-high-risk
7872,0,0,0,0,low-risk
78720,18,104,143,265,medium-high-risk
78725,0,0,0,0,low-risk
78730,0,0,0,0,low-risk
7875,23,122,160,305,medium-high-risk
7876,0,0,0,0,low-risk
7877,48,150,181,379,high-risk
78775,0,0,0,0,low-risk
78777,0,0,0,0,low-risk
78780,12,207,183,402,high-risk
78784,26,135,176,337,high-risk
78790,12,138,155,305,medium-high-risk
78794,12,67,118,197,medium-low-risk
78798,0,0,0,0,low-risk
78801,22,118,167,307,medium-high-risk
78802,37,125,178,340,high-risk
78804,12,115,151,278,medium-high-risk
78823,0,0,0,0,low-risk
78824,39,149,196,384,high-risk
78828,15,81,147,243,medium-low-risk
78849,0,0,0,0,low-risk
78864,20,90,142,252,medium-high-risk
78868,19,71,138,228,medium-low-risk
78876,0,0,0,0,low-risk
78883,0,0,0,0,low-risk
78886,12,119,227,358,high-risk
78893,0,0,0,0,low-risk
78897,0,0,0,0,low-risk
78904,12,84,89,185,medium-low-risk
78915,17,117,153,287,medium-high-risk
78918,22,122,166,310,medium-high-risk
78919,0,0,0,0,low-risk
78932,0,0,0,0,low-risk
78946,16,79,133,228,medium-low-risk
78953,0,0,0,0,low-risk
78963,12,101,126,239,medium-low-risk
78964,12,94,216,322,medium-high-risk
78974,13,104,115,232,medium-low-risk
78988,12,127,190,329,medium-high-risk
78992,0,0,0,0,low-risk
78993,12,106,164,282,medium-high-risk
79024,0,0,0,0,low-risk
79031,0,0,0,0,low-risk
79033,38,138,219,395,high-risk
79051,20,131,190,341,high-risk
79064,12,128,148,288,medium-high-risk
79074,0,0,0,0,low-risk
79079,16,110,204,330,high-risk
79087,0,0,0,0,low-risk
7909,12,75,105,192,medium-low-risk
79091,12,151,170,333,high-risk
79100,14,83,104,201,medium-low-risk
79102,0,0,0,0,low-risk
79108,0,0,0,0,low-risk
79121,16,171,228,415,high-risk
79123,12,114,154,280,medium-high-risk
79132,36,149,216,401,high-risk
79137,0,0,0,0,low-risk
79141,13,72,109,194,medium-low-risk
79145,0,0,0,0,low-risk
79147,17,146,182,345,high-risk
79148,0,0,0,0,low-risk
79149,29,112,189,330,high-risk
7915,0,0,0,0,low-risk
79156,14,94,118,226,medium-low-risk
79161,12,116,141,269,medium-high-risk
79162,11,132,213,356,high-risk
79165,0,0,0,0,low-risk
7917,0,0,0,0,low-risk
79173,0,0,0,0,low-risk
79174,12,171,163,346,high-risk
79175,13,80,139,232,medium-low-risk
79196,12,131,207,350,high-risk
79200,0,0,0,0,low-risk
7921,0,0,0,0,low-risk
79214,0,0,0,0,low-risk
79215,0,0,0,0,low-risk
79222,0,0,0,0,low-risk
7924,0,0,0,0,low-risk
79242,0,0,0,0,low-risk
79254,0,0,0,0,low-risk
79262,0,0,0,0,low-risk
79273,12,130,141,283,medium-high-risk
79277,22,167,214,403,high-risk
79279,0,0,0,0,low-risk
79283,12,99,104,215,medium-low-risk
79304,23,171,221,415,high-risk
79325,0,0,0,0,low-risk
79368,0,0,0,0,low-risk
79381,0,0,0,0,low-risk
79384,12,108,126,246,medium-high-risk
79386,12,90,108,210,medium-low-risk
79390,0,0,0,0,low-risk
79391,12,106,212,330,high-risk
7940,0,0,0,0,low-risk
79411,48,144,217,409,high-risk
79412,38,173,197,408,high-risk
79415,30,101,144,275,medium-high-risk
79421,0,0,0,0,low-risk
79442,17,128,189,334,high-risk
79456,29,114,144,287,medium-high-risk
7946,0,0,0,0,low-risk
79468,13,117,200,330,high-risk
79471,0,0,0,0,low-risk
79480,12,130,162,304,medium-high-risk
79483,0,0,0,0,low-risk
7949,12,125,137,274,medium-high-risk
79494,0,0,0,0,low-risk
79495,17,114,153,284,medium-high-risk
79497,12,114,177,303,medium-high-risk
79498,0,0,0,0,low-risk
79500,12,119,143,274,medium-high-risk
79510,12,126,141,279,medium-high-risk
79512,13,123,225,361,high-risk
79518,12,138,277,427,high-risk
79519,19,145,183,347,high-risk
79531,17,83,124,224,medium-low-risk
79546,12,127,140,279,medium-high-risk
79550,33,145,207,385,high-risk
79551,37,129,160,326,medium-high-risk
79554,25,153,210,388,high-risk
79560,0,0,0,0,low-risk
79579,0,0,0,0,low-risk
79591,32,136,163,331,high-risk
79592,0,0,0,0,low-risk
7964,24,97,119,240,medium-low-risk
79642,0,0,0,0,low-risk
79654,0,0,0,0,low-risk
79655,0,0,0,0,low-risk
79656,12,134,161,307,medium-high-risk
7966,0,0,0,0,low-risk
79662,0,0,0,0,low-risk
79665,0,0,0,0,low-risk
79669,12,79,111,202,medium-low-risk
79674,12,158,177,347,high-risk
79677,12,128,145,285,medium-high-risk
79680,14,112,142,268,medium-high-risk
79690,0,0,0,0,low-risk
79698,12,118,131,261,medium-high-risk
79699,0,0,0,0,low-risk
7970,12,83,127,222,medium-low-risk
79703,0,0,0,0,low-risk
79713,0,0,0,0,low-risk
79716,13,101,132,246,medium-high-risk
79739,12,112,152,276,medium-high-risk
79746,14,84,129,227,medium-low-risk
79747,0,0,0,0,low-risk
79756,0,0,0,0,low-risk
79762,0,0,0,0,low-risk
79769,30,131,201,362,high-risk
79779,12,154,180,346,high-risk
7979,12,125,174,311,medium-high-risk
79792,0,0,0,0,low-risk
79815,0,0,0,0,low-risk
79829,12,130,168,310,medium-high-risk
79834,0,0,0,0,low-risk
7984,13,95,160,268,medium-high-risk
79841,12,85,129,226,medium-low-risk
79852,0,0,0,0,low-risk
79862,0,0,0,0,low-risk
79863,32,169,200,401,high-risk
79889,60,144,200,404,high-risk
7989,0,0,0,0,low-risk
79891,12,141,239,392,high-risk
79893,12,208,124,344,high-risk
79895,12,150,205,367,high-risk
79896,22,168,208,398,high-risk
79904,15,103,140,258,medium-high-risk
79910,25,185,253,463,high-risk
79920,0,0,0,0,low-risk
79924,50,140,180,370,high-risk
79941,12,107,163,282,medium-high-risk
79947,12,84,185,281,medium-high-risk
79951,29,109,159,297,medium-high-risk
79963,12,120,159,291,medium-high-risk
79971,12,144,179,335,high-risk
79987,25,103,158,286,medium-high-risk
79993,55,168,292,515,high-risk
79999,12,147,176,335,high-risk
80005,12,113,142,267,medium-high-risk
80006,12,93,60,165,medium-low-risk
8001,12,164,262,438,high-risk
80020,0,0,0,0,low-risk
80021,0,0,0,0,low-risk
8003,0,0,0,0,low-risk
80047,17,135,172,324,medium-high-risk
80064,12,141,181,334,high-risk
80065,16,130,214,360,high-risk
80068,13,65,93,171,medium-low-risk
80071,0,0,0,0,low-risk
80073,12,122,208,342,high-risk
80074,0,0,0,0,low-risk
80078,0,0,0,0,low-risk
80080,12,181,206,399,high-risk
80083,14,107,124,245,medium-high-risk
80101,0,0,0,0,low-risk
80106,12,100,133,245,medium-high-risk
80118,0,0,0,0,low-risk
80120,0,0,0,0,low-risk
80123,0,0,0,0,low-risk
80133,0,0,0,0,low-risk
80140,12,145,163,320,medium-high-risk
80143,0,0,0,0,low-risk
80144,12,142,207,361,high-risk
80149,30,136,197,363,high-risk
80150,12,155,180,347,high-risk
80158,0,0,0,0,low-risk
80180,0,0,0,0,low-risk
80186,12,164,160,336,high-risk
80202,52,227,221,500,high-risk
80205,0,0,0,0,low-risk
80207,0,0,0,0,low-risk
80211,13,145,180,338,high-risk
80216,23,136,214,373,high-risk
80220,0,0,0,0,low-risk
80223,0,0,0,0,low-risk
8024,12,166,201,379,high-risk
80242,0,0,0,0,low-risk
80245,12,154,308,474,high-risk
80250,15,143,234,392,high-risk
80251,0,0,0,0,low-risk
80252,12,123,178,313,medium-high-risk
80257,0,0,0,0,low-risk
80261,0,0,0,0,low-risk
80262,0,0,0,0,low-risk
80274,0,0,0,0,low-risk
80276,0,0,0,0,low-risk
80293,14,107,164,285,medium-high-risk
8030,0,0,0,0,low-risk
8031,24,109,215,348,high-risk
80317,0,0,0,0,low-risk
80323,27,147,188,362,high-risk
80330,0,0,0,0,low-risk
80331,0,0,0,0,low-risk
80333,17,92,127,236,medium-low-risk
80336,11,131,109,251,medium-high-risk
80353,38,105,259,402,high-risk
80355,0,0,0,0,low-risk
80382,0,0,0,0,low-risk
80383,0,0,0,0,low-risk
80414,33,160,249,442,high-risk
80424,12,99,116,227,medium-low-risk
80430,12,89,135,236,medium-low-risk
80438,12,122,165,299,medium-high-risk
80448,24,100,144,268,medium-high-risk
80455,21,122,179,322,medium-high-risk
80463,14,98,128,240,medium-low-risk
80477,12,96,126,234,medium-low-risk
80486,0,0,0,0,low-risk
80492,33,142,197,372,high-risk
80494,12,165,201,378,high-risk
80498,31,151,199,381,high-risk
80507,13,119,207,339,high-risk
80508,12,92,161,265,medium-high-risk
80512,12,179,220,411,high-risk
80526,42,197,274,513,high-risk
80529,0,0,0,0,low-risk
80536,29,87,161,277,medium-high-risk
80540,17,99,148,264,medium-high-risk
80556,0,0,0,0,low-risk
80558,26,155,238,419,high-risk
8057,0,0,0,0,low-risk
80574,0,0,0,0,low-risk
8058,17,99,127,243,medium-low-risk
80580,19,88,135,242,medium-low-risk
8059,33,184,247,464,high-risk
80590,12,123,165,300,medium-high-risk
80592,24,97,139,260,medium-high-risk
80597,43,162,206,411,high-risk
80598,32,147,188,367,high-risk
80606,26,95,193,314,medium-high-risk
80609,0,0,0,0,low-risk
8062,0,0,0,0,low-risk
80626,13,134,157,304,medium-high-risk
80627,13,136,186,335,high-risk
80631,0,0,0,0,low-risk
80632,12,137,158,307,medium-high-risk
80635,0,0,0,0,low-risk
80638,12,154,192,358,high-risk
80647,0,0,0,0,low-risk
8065,12,156,197,365,high-risk
80651,0,0,0,0,low-risk
80654,27,141,247,415,high-risk
80658,12,130,177,319,medium-high-risk
80661,12,122,176,310,medium-high-risk
80667,42,127,168,337,high-risk
80670,0,0,0,0,low-risk
80685,18,101,152,271,medium-high-risk
80691,0,0,0,0,low-risk
80695,12,138,149,299,medium-high-risk
80697,12,86,119,217,medium-low-risk
80701,0,0,0,0,low-risk
80702,0,0,0,0,low-risk
80711,12,179,202,393,high-risk
80727,0,0,0,0,low-risk
80748,0,0,0,0,low-risk
80751,0,0,0,0,low-risk
80752,12,96,128,236,medium-low-risk
80758,13,118,159,290,medium-high-risk
80762,16,122,173,311,medium-high-risk
80763,12,133,180,325,medium-high-risk
80767,12,182,241,435,high-risk
80772,12,116,160,288,medium-high-risk
80785,13,133,153,299,medium-high-risk
80787,0,0,0,0,low-risk
80792,12,115,139,266,medium-high-risk
80801,12,100,132,244,medium-low-risk
80808,12,162,219,393,high-risk
80816,12,123,142,277,medium-high-risk
80831,0,0,0,0,low-risk
80844,12,184,216,412,high-risk
80850,12,84,116,212,medium-low-risk
80869,56,169,221,446,high-risk
80870,0,0,0,0,low-risk
80884,12,145,198,355,high-risk
8089,12,47,82,141,medium-low-risk
80895,44,132,178,354,high-risk
80915,0,0,0,0,low-risk
80917,12,122,155,289,medium-high-risk
80925,13,96,148,257,medium-high-risk
80928,0,0,0,0,low-risk
80929,17,114,160,291,medium-high-risk
8094,42,130,211,383,high-risk
80950,19,92,125,236,medium-low-risk
80954,0,0,0,0,low-risk
80956,28,128,186,342,high-risk
80963,39,135,184,358,high-risk
8097,42,178,240,460,high-risk
80975,37,134,167,338,high-risk
80985,12,142,173,327,medium-high-risk
80990,0,0,0,0,low-risk
81012,12,130,177,319,medium-high-risk
81014,14,93,117,224,medium-low-risk
81026,12,116,185,313,medium-high-risk
81031,0,0,0,0,low-risk
81036,0,0,0,0,low-risk
81037,0,0,0,0,low-risk
8104,0,0,0,0,low-risk
81052,0,0,0,0,low-risk
81055,15,100,280,395,high-risk
81076,0,0,0,0,low-risk
81081,0,0,0,0,low-risk
8109,12,131,170,313,medium-high-risk
81094,0,0,0,0,low-risk
81110,0,0,0,0,low-risk
81112,0,0,0,0,low-risk
81121,12,92,122,226,medium-low-risk
8114,0,0,0,0,low-risk
81143,0,0,0,0,low-risk
81160,12,65,223,300,medium-high-risk
81166,0,0,0,0,low-risk
81179,12,130,155,297,medium-high-risk
81185,12,152,163,327,medium-high-risk
8119,0,0,0,0,low-risk
81198,0,0,0,0,low-risk
81202,13,132,219,364,high-risk
81217,0,0,0,0,low-risk
81218,20,269,197,486,high-risk
81219,12,153,164,329,medium-high-risk
81220,12,95,119,226,medium-low-risk
81222,0,0,0,0,low-risk
81228,0,0,0,0,low-risk
81237,23,94,142,259,medium-high-risk
81240,0,0,0,0,low-risk
81257,0,0,0,0,low-risk
81259,13,116,219,348,high-risk
81270,12,111,166,289,medium-high-risk
81284,0,0,0,0,low-risk
81295,12,147,168,327,medium-high-risk
81298,0,0,0,0,low-risk
81302,12,62,68,142,medium-low-risk
81309,12,115,142,269,medium-high-risk
81316,0,0,0,0,low-risk
8135,12,105,158,275,medium-high-risk
81352,26,159,230,415,high-risk
81357,0,0,0,0,low-risk
81366,0,0,0,0,low-risk
81373,36,152,205,393,high-risk
81375,12,150,180,342,high-risk
81377,0,0,0,0,low-risk
81381,20,128,178,326,medium-high-risk
81384,43,136,200,379,high-risk
81385,12,118,142,272,medium-high-risk
81399,0,0,0,0,low-risk
81402,22,112,160,294,medium-high-risk
81404,12,102,146,260,medium-high-risk
8141,0,0,0,0,low-risk
8142,0,0,0,0,low-risk
8143,12,126,167,305,medium-high-risk
81434,15,112,149,276,medium-high-risk
8144,17,117,160,294,medium-high-risk
81451,14,141,168,323,medium-high-risk
81455,11,131,177,319,medium-high-risk
81456,0,0,0,0,low-risk
81457,0,0,0,0,low-risk
81466,0,0,0,0,low-risk
81480,12,93,125,230,medium-low-risk
81487,12,126,152,290,medium-high-risk
81488,15,95,138,248,medium-high-risk
81493,24,162,255,441,high-risk
81497,12,148,157,317,medium-high-risk
81503,0,0,0,0,low-risk
81504,28,112,193,333,high-risk
81508,0,0,0,0,low-risk
81529,18,140,192,350,high-risk
81532,0,0,0,0,low-risk
81540,12,99,124,235,medium-low-risk
81551,0,0,0,0,low-risk
81568,12,140,172,324,medium-high-risk
81581,0,0,0,0,low-risk
81582,0,0,0,0,low-risk
81587,0,0,0,0,low-risk
81590,12,124,67,203,medium-low-risk
81593,12,121,137,270,medium-high-risk
81602,0,0,0,0,low-risk
81605,0,0,0,0,low-risk
81623,0,0,0,0,low-risk
81637,12,120,160,292,medium-high-risk
8164,46,150,285,481,high-risk
81648,17,131,184,332,high-risk
81649,12,125,159,296,medium-high-risk
81650,14,90,146,250,medium-high-risk
81652,12,110,197,319,medium-high-risk
81657,29,150,205,384,high-risk
8166,12,95,137,244,medium-low-risk
81676,12,103,153,268,medium-high-risk
81687,13,139,188,340,high-risk
8169,0,0,0,0,low-risk
81694,0,0,0,0,low-risk
81705,12,140,176,328,medium-high-risk
81719,40,138,166,344,high-risk
81722,0,0,0,0,low-risk
81725,0,0,0,0,low-risk
81729,12,120,159,291,medium-high-risk
81734,0,0,0,0,low-risk
81736,15,86,136,237,medium-low-risk
81738,12,81,115,208,medium-low-risk
81751,0,0,0,0,low-risk
81755,0,0,0,0,low-risk
81758,22,110,157,289,medium-high-risk
81768,0,0,0,0,low-risk
81770,0,0,0,0,low-risk
8178,0,0,0,0,low-risk
81784,26,182,259,467,high-risk
81785,18,83,143,244,medium-low-risk
8179,13,73,108,194,medium-low-risk
81793,22,95,131,248,medium-high-risk
8180,0,0,0,0,low-risk
81807,0,0,0,0,low-risk
8181,0,0,0,0,low-risk
81823,12,98,149,259,medium-high-risk
81825,12,78,111,201,medium-low-risk
81826,37,124,258,419,high-risk
81830,0,0,0,0,low-risk
81834,27,130,156,313,medium-high-risk
81835,12,73,89,174,medium-low-risk
81845,12,109,151,272,medium-high-risk
81855,24,96,163,283,medium-high-risk
81861,13,148,179,340,high-risk
81863,0,0,0,0,low-risk
81882,0,0,0,0,low-risk
81886,0,0,0,0,low-risk
81897,12,147,161,320,medium-high-risk
81901,32,117,150,299,medium-high-risk
81904,0,0,0,0,low-risk
81908,0,0,0,0,low-risk
81911,21,102,139,262,medium-high-risk
81912,17,137,159,313,medium-high-risk
81918,12,120,134,266,medium-high-risk
81919,23,98,137,258,medium-high-risk
81931,0,0,0,0,low-risk
8194,11,147,193,351,high-risk
81946,44,172,229,445,high-risk
81956,12,91,216,319,medium-high-risk
81959,0,0,0,0,low-risk
81963,35,249,237,521,high-risk
8197,12,107,137,256,medium-high-risk
81983,0,0,0,0,low-risk
81985,0,0,0,0,low-risk
82011,31,143,189,363,high-risk
82015,12,127,176,315,medium-high-risk
82019,12,138,176,326,medium-high-risk
8203,12,117,156,285,medium-high-risk
8204,0,0,0,0,low-risk
82050,0,0,0,0,low-risk
82058,21,135,183,339,high-risk
82073,12,126,142,280,medium-high-risk
82082,19,85,142,246,medium-high-risk
8209,0,0,0,0,low-risk
82104,12,136,146,294,medium-high-risk
82112,15,120,169,304,medium-high-risk
82132,0,0,0,0,low-risk
82133,0,0,0,0,low-risk
82135,0,0,0,0,low-risk
82140,0,0,0,0,low-risk
82153,0,0,0,0,low-risk
82168,0,0,0,0,low-risk
82181,41,171,216,428,high-risk
82199,12,132,156,300,medium-high-risk
82201,0,0,0,0,low-risk
8221,24,102,152,278,medium-high-risk
82216,0,0,0,0,low-risk
82224,12,143,314,469,high-risk
82240,46,119,437,602,high-risk
82257,0,0,0,0,low-risk
82267,15,118,115,248,medium-high-risk
82271,0,0,0,0,low-risk
82278,0,0,0,0,low-risk
8228,0,0,0,0,low-risk
82287,21,94,203,318,medium-high-risk
82294,0,0,0,0,low-risk
82313,12,164,197,373,high-risk
82317,28,111,174,313,medium-high-risk
8232,12,122,175,309,medium-high-risk
82323,0,0,0,0,low-risk
82327,0,0,0,0,low-risk
82341,12,138,179,329,medium-high-risk
82355,0,0,0,0,low-risk
8236,12,134,133,279,medium-high-risk
82362,51,188,236,475,high-risk
82366,0,0,0,0,low-risk
82375,13,77,113,203,medium-low-risk
82388,0,0,0,0,low-risk
82398,39,154,187,380,high-risk
82399,12,115,146,273,medium-high-risk
82406,34,123,369,526,high-risk
82414,0,0,0,0,low-risk
82427,12,96,115,223,medium-low-risk
82436,0,0,0,0,low-risk
82437,0,0,0,0,low-risk
82440,0,0,0,0,low-risk
82447,12,146,106,264,medium-high-risk
82452,12,68,74,154,medium-low-risk
82454,34,172,222,428,high-risk
82472,0,0,0,0,low-risk
82475,0,0,0,0,low-risk
82481,0,0,0,0,low-risk
82490,12,142,234,388,high-risk
82495,0,0,0,0,low-risk
8250,12,112,164,288,medium-high-risk
82505,13,79,116,208,medium-low-risk
82519,12,146,174,332,high-risk
82527,12,116,165,293,medium-high-risk
8253,15,89,133,237,medium-low-risk
82535,0,0,0,0,low-risk
82539,0,0,0,0,low-risk
82553,0,0,0,0,low-risk
82568,0,0,0,0,low-risk
82569,0,0,0,0,low-risk
82572,17,151,254,422,high-risk
82585,12,143,167,322,medium-high-risk
82590,20,76,141,237,medium-low-risk
8260,12,128,103,243,medium-low-risk
82601,0,0,0,0,low-risk
82606,0,0,0,0,low-risk
82608,0,0,0,0,low-risk
82610,0,0,0,0,low-risk
82614,0,0,0,0,low-risk
82617,19,125,190,334,high-risk
82638,27,138,204,369,high-risk
82639,12,159,196,367,high-risk
82647,12,79,117,208,medium-low-risk
82648,22,95,158,275,medium-high-risk
82651,18,144,177,339,high-risk
82652,12,118,143,273,medium-high-risk
82655,0,0,0,0,low-risk
8266,12,119,153,284,medium-high-risk
82665,26,99,189,314,medium-high-risk
8267,44,150,183,377,high-risk
82671,15,135,239,389,high-risk
82675,0,0,0,0,low-risk
82678,0,0,0,0,low-risk
8268,24,102,167,293,medium-high-risk
82680,23,109,171,303,medium-high-risk
82687,12,141,214,367,high-risk
82692,0,0,0,0,low-risk
82700,18,94,155,267,medium-high-risk
82704,12,138,144,294,medium-high-risk
82706,12,150,207,369,high-risk
82707,30,177,193,400,high-risk
82719,35,136,174,345,high-risk
8272,0,0,0,0,low-risk
82725,12,107,140,259,medium-high-risk
82739,0,0,0,0,low-risk
82744,12,93,130,235,medium-low-risk
82749,0,0,0,0,low-risk
82752,41,157,243,441,high-risk
82756,17,93,257,367,high-risk
82757,0,0,0,0,low-risk
82765,12,148,198,358,high-risk
82767,12,153,174,339,high-risk
82780,12,160,200,372,high-risk
82786,0,0,0,0,low-risk
82787,18,82,154,254,medium-high-risk
82796,24,119,147,290,medium-high-risk
82802,16,97,141,254,medium-high-risk
82806,33,104,141,278,medium-high-risk
82816,19,143,186,348,high-risk
82818,17,118,171,306,medium-high-risk
82823,18,117,159,294,medium-high-risk
82829,12,136,128,276,medium-high-risk
82846,0,0,0,0,low-risk
82853,12,117,148,277,medium-high-risk
82856,49,187,231,467,high-risk
82861,12,104,131,247,medium-high-risk
82862,12,125,160,297,medium-high-risk
82865,12,104,217,333,high-risk
82868,0,0,0,0,low-risk
82871,0,0,0,0,low-risk
82874,22,142,183,347,high-risk
82882,0,0,0,0,low-risk
82886,12,105,140,257,medium-high-risk
82887,21,125,162,308,medium-high-risk
82902,0,0,0,0,low-risk
82908,0,0,0,0,low-risk
82909,12,132,81,225,medium-low-risk
82912,17,98,131,246,medium-high-risk
82923,0,0,0,0,low-risk
82931,12,134,178,324,medium-high-risk
82934,0,0,0,0,low-risk
8294,12,106,127,245,medium-high-risk
82946,0,0,0,0,low-risk
8295,18,81,140,239,medium-low-risk
82953,12,141,167,320,medium-high-risk
82958,12,152,186,350,high-risk
8296,12,145,159,316,medium-high-risk
82968,0,0,0,0,low-risk
8297,0,0,0,0,low-risk
82980,43,152,197,392,high-risk
82990,0,0,0,0,low-risk
82997,0,0,0,0,low-risk
83011,0,0,0,0,low-risk
83029,0,0,0,0,low-risk
83030,22,103,219,344,high-risk
83033,0,0,0,0,low-risk
83036,12,111,133,256,medium-high-risk
83037,50,154,212,416,high-risk
83041,36,130,159,325,medium-high-risk
83050,12,140,200,352,high-risk
83054,0,0,0,0,low-risk
8306,27,105,160,292,medium-high-risk
83061,15,103,145,263,medium-high-risk
83067,12,129,164,305,medium-high-risk
83068,41,108,164,313,medium-high-risk
8307,13,169,216,398,high-risk
83071,0,0,0,0,low-risk
83082,0,0,0,0,low-risk
83085,0,0,0,0,low-risk
83092,14,128,204,346,high-risk
83100,15,91,130,236,medium-low-risk
83116,0,0,0,0,low-risk
83121,12,84,115,211,medium-low-risk
83127,19,107,175,301,medium-high-risk
83134,0,0,0,0,low-risk
83135,0,0,0,0,low-risk
83145,12,149,185,346,high-risk
83152,0,0,0,0,low-risk
83163,0,0,0,0,low-risk
83164,13,154,323,490,high-risk
83177,12,101,118,231,medium-low-risk
83178,18,123,151,292,medium-high-risk
83191,0,0,0,0,low-risk
83195,12,121,180,313,medium-high-risk
83199,0,0,0,0,low-risk
83201,38,169,240,447,high-risk
83209,0,0,0,0,low-risk
8321,0,0,0,0,low-risk
83210,16,111,148,275,medium-high-risk
83215,12,145,183,340,high-risk
83222,12,137,161,310,medium-high-risk
83236,12,135,182,329,medium-high-risk
83237,0,0,0,0,low-risk
83257,0,0,0,0,low-risk
83264,33,130,229,392,high-risk
8327,39,133,206,378,high-risk
8328,17,110,150,277,medium-high-risk
83290,0,0,0,0,low-risk
83294,0,0,0,0,low-risk
83295,12,134,181,327,medium-high-risk
83304,12,126,152,290,medium-high-risk
8331,12,193,231,436,high-risk
83312,0,0,0,0,low-risk
83323,28,161,217,406,high-risk
83325,12,143,185,340,high-risk
83329,0,0,0,0,low-risk
8334,12,156,197,365,high-risk
83345,12,129,207,348,high-risk
83346,0,0,0,0,low-risk
83354,0,0,0,0,low-risk
83397,0,0,0,0,low-risk
83402,35,124,165,324,medium-high-risk
83404,0,0,0,0,low-risk
83426,0,0,0,0,low-risk
83427,12,126,153,291,medium-high-risk
83454,12,108,147,267,medium-high-risk
83457,12,116,157,285,medium-high-risk
83462,42,124,171,337,high-risk
83470,0,0,0,0,low-risk
83481,18,125,163,306,medium-high-risk
83485,0,0,0,0,low-risk
83493,12,94,111,217,medium-low-risk
83505,0,0,0,0,low-risk
83507,0,0,0,0,low-risk
83511,0,0,0,0,low-risk
83525,14,82,110,206,medium-low-risk
83533,12,91,108,211,medium-low-risk
83551,12,106,140,258,medium-high-risk
83557,0,0,0,0,low-risk
83562,0,0,0,0,low-risk
83565,0,0,0,0,low-risk
83569,0,0,0,0,low-risk
83572,0,0,0,0,low-risk
83574,12,125,148,285,medium-high-risk
83578,12,107,201,320,medium-high-risk
83585,41,157,195,393,high-risk
83587,0,0,0,0,low-risk
83591,66,182,334,582,high-risk
83593,21,143,189,353,high-risk
83596,0,0,0,0,low-risk
83599,12,126,226,364,high-risk
8360,0,0,0,0,low-risk
83601,12,146,207,365,high-risk
83611,0,0,0,0,low-risk
83619,0,0,0,0,low-risk
83623,0,0,0,0,low-risk
83668,0,0,0,0,low-risk
83669,0,0,0,0,low-risk
83681,12,131,153,296,medium-high-risk
83683,0,0,0,0,low-risk
83689,19,67,112,198,medium-low-risk
8369,0,0,0,0,low-risk
83701,0,0,0,0,low-risk
83704,15,96,136,247,medium-high-risk
83715,0,0,0,0,low-risk
83719,21,104,217,342,high-risk
83726,12,127,156,295,medium-high-risk
83741,12,143,179,334,high-risk
83742,12,307,190,509,high-risk
83746,0,0,0,0,low-risk
83747,0,0,0,0,low-risk
83748,0,0,0,0,low-risk
83755,0,0,0,0,low-risk
83757,0,0,0,0,low-risk
83764,0,0,0,0,low-risk
83765,12,229,141,382,high-risk
8377,12,169,191,372,high-risk
83770,0,0,0,0,low-risk
83785,0,0,0,0,low-risk
83788,12,80,122,214,medium-low-risk
83789,12,118,128,258,medium-high-risk
83807,0,0,0,0,low-risk
8381,37,125,163,325,medium-high-risk
83810,12,106,130,248,medium-high-risk
83816,21,89,188,298,medium-high-risk
83818,12,170,204,386,high-risk
83844,0,0,0,0,low-risk
83845,12,89,119,220,medium-low-risk
83848,17,81,141,239,medium-low-risk
8386,19,91,136,246,medium-high-risk
83869,0,0,0,0,low-risk
8387,18,113,160,291,medium-high-risk
83870,17,104,134,255,medium-high-risk
83879,0,0,0,0,low-risk
83899,0,0,0,0,low-risk
83900,0,0,0,0,low-risk
83907,13,205,232,450,high-risk
83908,12,118,128,258,medium-high-risk
83909,0,0,0,0,low-risk
83910,12,132,157,301,medium-high-risk
83913,0,0,0,0,low-risk
83919,0,0,0,0,low-risk
83923,0,0,0,0,low-risk
83926,14,133,159,306,medium-high-risk
83928,12,88,86,186,medium-low-risk
83934,12,102,139,253,medium-high-risk
83935,12,165,209,386,high-risk
83951,13,82,125,220,medium-low-risk
83957,0,0,0,0,low-risk
83960,13,148,200,361,high-risk
83964,0,0,0,0,low-risk
83968,14,105,145,264,medium-high-risk
83970,0,0,0,0,low-risk
83980,0,0,0,0,low-risk
83981,25,229,177,431,high-risk
83982,12,126,155,293,medium-high-risk
83984,31,125,169,325,medium-high-risk
83985,12,96,130,238,medium-low-risk
83989,0,0,0,0,low-risk
83991,0,0,0,0,low-risk
83997,0,0,0,0,low-risk
83998,13,143,285,441,high-risk
84000,12,152,182,346,high-risk
84020,0,0,0,0,low-risk
84025,0,0,0,0,low-risk
84041,14,154,292,460,high-risk
84051,12,127,140,279,medium-high-risk
84058,0,0,0,0,low-risk
84061,33,142,212,387,high-risk
84070,14,135,180,329,medium-high-risk
8408,0,0,0,0,low-risk
84090,0,0,0,0,low-risk
84110,0,0,0,0,low-risk
84112,0,0,0,0,low-risk
84119,16,99,126,241,medium-low-risk
84124,0,0,0,0,low-risk
84128,12,110,171,293,medium-high-risk
8413,0,0,0,0,low-risk
84131,12,82,166,260,medium-high-risk
84132,16,145,285,446,high-risk
84134,11,120,208,339,high-risk
84136,14,111,138,263,medium-high-risk
84138,12,130,166,308,medium-high-risk
84143,12,238,118,368,high-risk
84151,12,125,96,233,medium-low-risk
84157,0,0,0,0,low-risk
84162,51,152,183,386,high-risk
84169,12,142,164,318,medium-high-risk
8418,12,125,147,284,medium-high-risk
84184,0,0,0,0,low-risk
84189,12,124,170,306,medium-high-risk
8419,0,0,0,0,low-risk
84192,12,144,184,340,high-risk
84193,32,248,203,483,high-risk
84208,0,0,0,0,low-risk
84217,0,0,0,0,low-risk
84220,0,0,0,0,low-risk
84224,12,144,187,343,high-risk
84231,0,0,0,0,low-risk
84233,0,0,0,0,low-risk
8424,0,0,0,0,low-risk
84242,27,97,145,269,medium-high-risk
84251,18,106,155,279,medium-high-risk
84262,34,196,226,456,high-risk
84283,14,138,227,379,high-risk
84286,0,0,0,0,low-risk
84290,0,0,0,0,low-risk
84298,12,127,158,297,medium-high-risk
84302,12,97,128,237,medium-low-risk
84309,0,0,0,0,low-risk
8431,12,132,169,313,medium-high-risk
84316,12,149,105,266,medium-high-risk
84324,0,0,0,0,low-risk
84325,0,0,0,0,low-risk
84326,12,166,187,365,high-risk
84327,0,0,0,0,low-risk
84336,28,149,183,360,high-risk
84354,23,102,129,254,medium-high-risk
84355,0,0,0,0,low-risk
84358,14,150,306,470,high-risk
84363,12,124,157,293,medium-high-risk
84377,12,118,136,266,medium-high-risk
8438,12,147,250,409,high-risk
84388,0,0,0,0,low-risk
84398,0,0,0,0,low-risk
84410,0,0,0,0,low-risk
84411,0,0,0,0,low-risk
84414,0,0,0,0,low-risk
84417,29,120,159,308,medium-high-risk
8442,0,0,0,0,low-risk
84430,0,0,0,0,low-risk
84432,18,129,180,327,medium-high-risk
84437,29,195,256,480,high-risk
84438,0,0,0,0,low-risk
84450,0,0,0,0,low-risk
84452,0,0,0,0,low-risk
84454,17,140,186,343,high-risk
84455,0,0,0,0,low-risk
84459,25,98,160,283,medium-high-risk
84472,33,122,183,338,high-risk
84479,0,0,0,0,low-risk
84484,12,138,203,353,high-risk
84486,0,0,0,0,low-risk
8449,0,0,0,0,low-risk
84496,12,106,126,244,medium-low-risk
84498,12,110,143,265,medium-high-risk
84500,0,0,0,0,low-risk
84504,12,113,115,240,medium-low-risk
84510,0,0,0,0,low-risk
84525,0,0,0,0,low-risk
84531,0,0,0,0,low-risk
84535,24,147,190,361,high-risk
8454,0,0,0,0,low-risk
84541,0,0,0,0,low-risk
84550,26,159,200,385,high-risk
84553,48,172,210,430,high-risk
84554,0,0,0,0,low-risk
84574,0,0,0,0,low-risk
84579,28,126,230,384,high-risk
84583,33,114,144,291,medium-high-risk
84585,0,0,0,0,low-risk
84594,12,109,155,276,medium-high-risk
84603,0,0,0,0,low-risk
84606,0,0,0,0,low-risk
84609,12,146,186,344,high-risk
84613,38,160,182,380,high-risk
84615,0,0,0,0,low-risk
84618,0,0,0,0,low-risk
84625,32,110,151,293,medium-high-risk
84632,16,90,125,231,medium-low-risk
84641,0,0,0,0,low-risk
84655,17,116,167,300,medium-high-risk
84658,12,181,220,413,high-risk
84683,0,0,0,0,low-risk
84687,33,132,170,335,high-risk
84699,20,73,142,235,medium-low-risk
8470,0,0,0,0,low-risk
84702,12,145,190,347,high-risk
84707,0,0,0,0,low-risk
84708,27,98,166,291,medium-high-risk
8472,13,145,249,407,high-risk
84726,0,0,0,0,low-risk
8473,30,184,267,481,high-risk
8474,12,125,140,277,medium-high-risk
84740,21,109,152,282,medium-high-risk
8475,0,0,0,0,low-risk
84757,12,153,204,369,high-risk
84763,12,134,171,317,medium-high-risk
84766,12,103,112,227,medium-low-risk
84779,12,130,180,322,medium-high-risk
84785,0,0,0,0,low-risk
84786,12,112,153,277,medium-high-risk
84787,0,0,0,0,low-risk
84791,20,98,158,276,medium-high-risk
84795,26,119,163,308,medium-high-risk
84802,0,0,0,0,low-risk
84803,12,141,184,337,high-risk
84818,19,282,186,487,high-risk
84822,0,0,0,0,low-risk
84823,0,0,0,0,low-risk
84824,0,0,0,0,low-risk
84826,0,0,0,0,low-risk
84840,21,113,165,299,medium-high-risk
84857,0,0,0,0,low-risk
84858,0,0,0,0,low-risk
84860,0,0,0,0,low-risk
84863,12,116,142,270,medium-high-risk
8487,12,99,127,238,medium-low-risk
84870,0,0,0,0,low-risk
84876,22,148,202,372,high-risk
84878,0,0,0,0,low-risk
84880,0,0,0,0,low-risk
8489,0,0,0,0,low-risk
84893,12,118,155,285,medium-high-risk
84895,11,120,130,261,medium-high-risk
84897,13,141,201,355,high-risk
84905,23,117,159,299,medium-high-risk
84925,32,159,210,401,high-risk
84926,12,140,162,314,medium-high-risk
84931,12,107,122,241,medium-low-risk
84934,14,138,185,337,high-risk
84945,24,111,153,288,medium-high-risk
84946,12,146,166,324,medium-high-risk
84947,0,0,0,0,low-risk
84948,24,146,212,382,high-risk
84949,0,0,0,0,low-risk
84959,12,103,157,272,medium-high-risk
84961,19,150,220,389,high-risk
84985,0,0,0,0,low-risk
84999,34,128,165,327,medium-high-risk
8501,0,0,0,0,low-risk
85014,0,0,0,0,low-risk
85023,0,0,0,0,low-risk
85030,26,138,212,376,high-risk
85037,0,0,0,0,low-risk
85045,33,129,178,340,high-risk
85054,0,0,0,0,low-risk
85059,0,0,0,0,low-risk
8506,12,211,172,395,high-risk
85061,0,0,0,0,low-risk
85062,20,94,152,266,medium-high-risk
85064,0,0,0,0,low-risk
8507,12,137,188,337,high-risk
85072,0,0,0,0,low-risk
85079,12,154,233,399,high-risk
85083,0,0,0,0,low-risk
85084,0,0,0,0,low-risk
85092,0,0,0,0,low-risk
85096,0,0,0,0,low-risk
85119,12,128,191,331,high-risk
85124,0,0,0,0,low-risk
85130,0,0,0,0,low-risk
85144,12,149,230,391,high-risk
85149,0,0,0,0,low-risk
85153,12,120,149,281,medium-high-risk
85162,23,119,157,299,medium-high-risk
85169,0,0,0,0,low-risk
85170,11,135,151,297,medium-high-risk
85171,0,0,0,0,low-risk
85179,16,147,268,431,high-risk
8518,12,145,179,336,high-risk
85181,0,0,0,0,low-risk
85182,0,0,0,0,low-risk
85194,0,0,0,0,low-risk
85197,0,0,0,0,low-risk
85199,12,131,157,300,medium-high-risk
85200,26,140,188,354,high-risk
85204,0,0,0,0,low-risk
85207,0,0,0,0,low-risk
85221,0,0,0,0,low-risk
85231,0,0,0,0,low-risk
85247,12,129,172,313,medium-high-risk
85251,0,0,0,0,low-risk
85262,12,78,114,204,medium-low-risk
85270,23,147,169,339,high-risk
85273,0,0,0,0,low-risk
85278,26,152,196,374,high-risk
85292,0,0,0,0,low-risk
85293,20,86,169,275,medium-high-risk
85294,17,144,187,348,high-risk
85296,0,0,0,0,low-risk
85311,12,153,176,341,high-risk
85314,12,115,148,275,medium-high-risk
85323,12,118,209,339,high-risk
85332,0,0,0,0,low-risk
85334,0,0,0,0,low-risk
85335,0,0,0,0,low-risk
85342,0,0,0,0,low-risk
85345,13,110,171,294,medium-high-risk
85346,0,0,0,0,low-risk
8535,0,0,0,0,low-risk
85356,0,0,0,0,low-risk
85362,28,147,217,392,high-risk
85368,41,187,216,444,high-risk
85374,0,0,0,0,low-risk
85378,33,246,246,525,high-risk
85391,12,122,166,300,medium-high-risk
85406,0,0,0,0,low-risk
85410,0,0,0,0,low-risk
85411,56,154,471,681,high-risk
85422,24,104,145,273,medium-high-risk
85436,12,165,214,391,high-risk
85442,0,0,0,0,low-risk
85455,0,0,0,0,low-risk
85457,12,101,110,223,medium-low-risk
85463,0,0,0,0,low-risk
85471,0,0,0,0,low-risk
85477,12,144,165,321,medium-high-risk
85489,0,0,0,0,low-risk
8549,0,0,0,0,low-risk
85491,0,0,0,0,low-risk
85492,25,123,209,357,high-risk
85499,0,0,0,0,low-risk
85508,14,132,280,426,high-risk
85517,50,139,246,435,high-risk
85519,12,144,160,316,medium-high-risk
85529,26,131,172,329,medium-high-risk
85531,0,0,0,0,low-risk
85532,15,86,112,213,medium-low-risk
85534,0,0,0,0,low-risk
85536,14,145,300,459,high-risk
85538,0,0,0,0,low-risk
85539,33,165,232,430,high-risk
85542,0,0,0,0,low-risk
85545,19,187,273,479,high-risk
85548,0,0,0,0,low-risk
85550,0,0,0,0,low-risk
85553,0,0,0,0,low-risk
8556,15,116,157,288,medium-high-risk
85563,0,0,0,0,low-risk
85568,12,132,96,240,medium-low-risk
8557,0,0,0,0,low-risk
85593,15,175,222,412,high-risk
85604,0,0,0,0,low-risk
85615,0,0,0,0,low-risk
85621,0,0,0,0,low-risk
85635,46,131,195,372,high-risk
8564,0,0,0,0,low-risk
85642,12,185,180,377,high-risk
85643,0,0,0,0,low-risk
8565,23,94,226,343,high-risk
85659,0,0,0,0,low-risk
85660,0,0,0,0,low-risk
85664,12,99,122,233,medium-low-risk
85673,0,0,0,0,low-risk
8568,12,112,162,286,medium-high-risk
85684,19,132,187,338,high-risk
85686,0,0,0,0,low-risk
85691,15,166,212,393,high-risk
85701,12,164,185,361,high-risk
8572,12,133,174,319,medium-high-risk
85734,0,0,0,0,low-risk
85755,20,139,188,347,high-risk
85764,14,146,330,490,high-risk
85767,12,146,168,326,medium-high-risk
85774,12,116,157,285,medium-high-risk
85796,0,0,0,0,low-risk
85824,12,88,156,256,medium-high-risk
8583,12,108,156,276,medium-high-risk
85864,0,0,0,0,low-risk
85883,19,164,309,492,high-risk
85885,12,101,118,231,medium-low-risk
85896,0,0,0,0,low-risk
85898,12,152,221,385,high-risk
85899,0,0,0,0,low-risk
85902,0,0,0,0,low-risk
85909,0,0,0,0,low-risk
85911,0,0,0,0,low-risk
85916,0,0,0,0,low-risk
85917,27,174,242,443,high-risk
85921,34,153,199,386,high-risk
85945,12,120,162,294,medium-high-risk
85948,16,152,191,359,high-risk
85955,0,0,0,0,low-risk
85958,12,109,127,248,medium-high-risk
85971,0,0,0,0,low-risk
85983,19,127,159,305,medium-high-risk
85984,12,108,128,248,medium-high-risk
85987,0,0,0,0,low-risk
85989,0,0,0,0,low-risk
86004,0,0,0,0,low-risk
86008,43,137,407,587,high-risk
86009,0,0,0,0,low-risk
86025,0,0,0,0,low-risk
8603,24,113,178,315,medium-high-risk
86030,0,0,0,0,low-risk
86032,0,0,0,0,low-risk
86035,0,0,0,0,low-risk
86046,0,0,0,0,low-risk
86057,0,0,0,0,low-risk
86064,0,0,0,0,low-risk
8607,12,202,264,478,high-risk
86072,14,135,182,331,high-risk
86073,35,139,170,344,high-risk
86107,17,96,128,241,medium-low-risk
8612,0,0,0,0,low-risk
86121,13,167,290,470,high-risk
86124,0,0,0,0,low-risk
86134,0,0,0,0,low-risk
86141,0,0,0,0,low-risk
86146,0,0,0,0,low-risk
86153,0,0,0,0,low-risk
86156,21,163,214,398,high-risk
86161,12,158,187,357,high-risk
86178,12,135,151,298,medium-high-risk
8619,0,0,0,0,low-risk
86194,12,159,340,511,high-risk
86195,31,114,170,315,medium-high-risk
86199,12,176,194,382,high-risk
86202,0,0,0,0,low-risk
86203,12,70,121,203,medium-low-risk
8621,0,0,0,0,low-risk
86210,0,0,0,0,low-risk
86211,0,0,0,0,low-risk
86213,0,0,0,0,low-risk
86214,12,112,162,286,medium-high-risk
86227,16,104,146,266,medium-high-risk
86229,0,0,0,0,low-risk
8623,0,0,0,0,low-risk
86237,0,0,0,0,low-risk
86248,0,0,0,0,low-risk
8625,13,115,155,283,medium-high-risk
86253,16,101,120,237,medium-low-risk
86256,33,157,200,390,high-risk
8626,0,0,0,0,low-risk
86266,12,133,167,312,medium-high-risk
86267,12,107,143,262,medium-high-risk
86269,12,99,147,258,medium-high-risk
86272,12,136,152,300,medium-high-risk
86278,0,0,0,0,low-risk
86294,12,144,171,327,medium-high-risk
86299,0,0,0,0,low-risk
86308,0,0,0,0,low-risk
86319,0,0,0,0,low-risk
86320,23,112,136,271,medium-high-risk
86321,0,0,0,0,low-risk
86322,0,0,0,0,low-risk
86326,0,0,0,0,low-risk
8633,16,191,216,423,high-risk
86333,0,0,0,0,low-risk
86352,0,0,0,0,low-risk
86355,13,92,134,239,medium-low-risk
86356,17,71,104,192,medium-low-risk
86358,0,0,0,0,low-risk
86366,0,0,0,0,low-risk
8637,0,0,0,0,low-risk
86380,33,121,168,322,medium-high-risk
86381,22,142,175,339,high-risk
86396,0,0,0,0,low-risk
86399,12,148,197,357,high-risk
86401,0,0,0,0,low-risk
86403,0,0,0,0,low-risk
86406,0,0,0,0,low-risk
86414,12,114,191,317,medium-high-risk
86417,18,101,171,290,medium-high-risk
86425,0,0,0,0,low-risk
86429,0,0,0,0,low-risk
86434,0,0,0,0,low-risk
86436,0,0,0,0,low-risk
86440,12,157,262,431,high-risk
86448,12,128,155,295,medium-high-risk
86455,0,0,0,0,low-risk
86456,0,0,0,0,low-risk
86458,12,131,179,322,medium-high-risk
86461,0,0,0,0,low-risk
86466,0,0,0,0,low-risk
86475,0,0,0,0,low-risk
86476,0,0,0,0,low-risk
86503,18,128,170,316,medium-high-risk
86519,28,167,229,424,high-risk
8652,0,0,0,0,low-risk
86521,0,0,0,0,low-risk
86530,0,0,0,0,low-risk
86539,12,136,160,308,medium-high-risk
8655,28,137,192,357,high-risk
86551,51,148,211,410,high-risk
86554,18,127,153,298,medium-high-risk
86557,0,0,0,0,low-risk
86558,12,154,191,357,high-risk
86560,15,129,234,378,high-risk
86565,0,0,0,0,low-risk
86572,12,90,165,267,medium-high-risk
86577,0,0,0,0,low-risk
86578,0,0,0,0,low-risk
86580,20,121,209,350,high-risk
86583,12,108,110,230,medium-low-risk
86597,0,0,0,0,low-risk
8661,12,99,133,244,medium-low-risk
86624,40,145,172,357,high-risk
86637,12,143,169,324,medium-high-risk
86648,0,0,0,0,low-risk
86649,0,0,0,0,low-risk
86656,0,0,0,0,low-risk
86659,0,0,0,0,low-risk
86662,0,0,0,0,low-risk
86678,0,0,0,0,low-risk
8668,12,117,125,254,medium-high-risk
86693,16,99,143,258,medium-high-risk
86698,17,151,238,406,high-risk
86706,0,0,0,0,low-risk
86710,12,86,101,199,medium-low-risk
86715,0,0,0,0,low-risk
86723,0,0,0,0,low-risk
86739,16,155,210,381,high-risk
86767,0,0,0,0,low-risk
86772,28,122,149,299,medium-high-risk
86782,41,166,196,403,high-risk
86793,0,0,0,0,low-risk
86800,0,0,0,0,low-risk
86803,15,126,225,366,high-risk
86805,0,0,0,0,low-risk
86809,0,0,0,0,low-risk
86810,0,0,0,0,low-risk
86819,12,103,119,234,medium-low-risk
8682,12,105,129,246,medium-high-risk
86821,0,0,0,0,low-risk
8683,0,0,0,0,low-risk
86872,0,0,0,0,low-risk
86881,40,144,174,358,high-risk
86885,0,0,0,0,low-risk
86899,19,177,256,452,high-risk
8691,14,142,226,382,high-risk
86916,0,0,0,0,low-risk
86922,37,123,169,329,medium-high-risk
86926,12,100,142,254,medium-high-risk
86927,12,151,156,319,medium-high-risk
86933,14,116,137,267,medium-high-risk
86934,0,0,0,0,low-risk
86959,15,140,207,362,high-risk
86964,12,128,169,309,medium-high-risk
86965,26,236,270,532,high-risk
86967,12,126,162,300,medium-high-risk
86969,0,0,0,0,low-risk
86984,13,137,176,326,medium-high-risk
86985,0,0,0,0,low-risk
87005,13,157,202,372,high-risk
87006,12,148,167,327,medium-high-risk
87007,0,0,0,0,low-risk
8701,0,0,0,0,low-risk
87011,0,0,0,0,low-risk
87015,0,0,0,0,low-risk
87017,12,117,191,320,medium-high-risk
87018,12,106,143,261,medium-high-risk
87025,12,106,133,251,medium-high-risk
87026,0,0,0,0,low-risk
87036,12,92,115,219,medium-low-risk
8704,0,0,0,0,low-risk
87048,12,104,120,236,medium-low-risk
87054,0,0,0,0,low-risk
87056,0,0,0,0,low-risk
87061,12,98,113,223,medium-low-risk
87068,12,169,232,413,high-risk
87072,0,0,0,0,low-risk
87073,0,0,0,0,low-risk
87079,0,0,0,0,low-risk
87080,12,133,104,249,medium-high-risk
87087,12,119,121,252,medium-high-risk
87098,12,158,196,366,high-risk
87107,0,0,0,0,low-risk
87108,30,156,228,414,high-risk
87118,12,98,134,244,medium-low-risk
87125,0,0,0,0,low-risk
87165,0,0,0,0,low-risk
87169,0,0,0,0,low-risk
87174,0,0,0,0,low-risk
87175,11,148,160,319,medium-high-risk
8718,26,106,145,277,medium-high-risk
8719,0,0,0,0,low-risk
87195,0,0,0,0,low-risk
87199,0,0,0,0,low-risk
8720,0,0,0,0,low-risk
87203,0,0,0,0,low-risk
87207,12,133,175,320,medium-high-risk
87217,15,160,277,452,high-risk
87218,12,108,148,268,medium-high-risk
87226,12,89,121,222,medium-low-risk
87250,0,0,0,0,low-risk
87252,0,0,0,0,low-risk
87262,0,0,0,0,low-risk
87263,12,88,122,222,medium-low-risk
87264,16,81,117,214,medium-low-risk
87271,12,184,211,407,high-risk
87273,12,116,171,299,medium-high-risk
87301,0,0,0,0,low-risk
87302,24,161,226,411,high-risk
87308,23,158,176,357,high-risk
87324,16,199,363,578,high-risk
87330,15,98,146,259,medium-high-risk
87332,12,158,179,349,high-risk
87344,13,103,122,238,medium-low-risk
87355,12,150,201,363,high-risk
87369,28,215,197,440,high-risk
87372,49,155,189,393,high-risk
87381,0,0,0,0,low-risk
87388,12,152,176,340,high-risk
87390,0,0,0,0,low-risk
87398,0,0,0,0,low-risk
8741,14,119,168,301,medium-high-risk
87425,0,0,0,0,low-risk
87427,0,0,0,0,low-risk
87434,0,0,0,0,low-risk
87438,0,0,0,0,low-risk
87439,26,120,172,318,medium-high-risk
8744,12,97,202,311,medium-high-risk
87459,0,0,0,0,low-risk
87469,0,0,0,0,low-risk
87486,12,162,207,381,high-risk
87495,0,0,0,0,low-risk
87516,12,136,211,359,high-risk
87528,25,133,173,331,high-risk
87531,14,99,155,268,medium-high-risk
87539,0,0,0,0,low-risk
87545,28,159,210,397,high-risk
87547,23,126,197,346,high-risk
87548,0,0,0,0,low-risk
87549,13,115,173,301,medium-high-risk
87568,17,173,255,445,high-risk
87573,12,126,210,348,high-risk
87578,12,104,111,227,medium-low-risk
87579,0,0,0,0,low-risk
87582,37,160,197,394,high-risk
87595,15,92,116,223,medium-low-risk
87597,0,0,0,0,low-risk
87599,12,112,170,294,medium-high-risk
87604,12,145,155,312,medium-high-risk
87605,12,132,166,310,medium-high-risk
87615,28,137,167,332,high-risk
87617,20,164,228,412,high-risk
87632,0,0,0,0,low-risk
87633,12,129,142,283,medium-high-risk
8764,0,0,0,0,low-risk
87646,0,0,0,0,low-risk
87651,20,90,117,227,medium-low-risk
87657,0,0,0,0,low-risk
87662,24,109,231,364,high-risk
87668,14,163,224,401,high-risk
87674,12,109,141,262,medium-high-risk
87679,0,0,0,0,low-risk
87692,26,126,179,331,high-risk
87694,0,0,0,0,low-risk
87713,0,0,0,0,low-risk
87718,28,113,141,282,medium-high-risk
87725,31,132,176,339,high-risk
87731,12,117,158,287,medium-high-risk
87733,0,0,0,0,low-risk
87738,0,0,0,0,low-risk
87747,0,0,0,0,low-risk
87755,0,0,0,0,low-risk
87762,14,86,170,270,medium-high-risk
87764,0,0,0,0,low-risk
87765,12,118,181,311,medium-high-risk
87766,0,0,0,0,low-risk
87768,12,105,117,234,medium-low-risk
87769,12,124,206,342,high-risk
87770,13,130,209,352,high-risk
87771,19,96,141,256,medium-high-risk
87772,18,97,149,264,medium-high-risk
87778,0,0,0,0,low-risk
87779,0,0,0,0,low-risk
87805,24,113,220,357,high-risk
87814,18,85,134,237,medium-low-risk
87815,12,112,173,297,medium-high-risk
87821,20,127,173,320,medium-high-risk
87837,0,0,0,0,low-risk
87845,0,0,0,0,low-risk
87847,12,141,171,324,medium-high-risk
87850,0,0,0,0,low-risk
87852,13,77,103,193,medium-low-risk
87861,12,128,166,306,medium-high-risk
87865,12,157,220,389,high-risk
87867,12,125,175,312,medium-high-risk
87873,12,113,129,254,medium-high-risk
87886,12,137,174,323,medium-high-risk
87911,0,0,0,0,low-risk
87926,47,133,230,410,high-risk
87935,25,102,156,283,medium-high-risk
87944,0,0,0,0,low-risk
87954,34,104,188,326,medium-high-risk
87971,12,140,234,386,high-risk
87980,12,112,163,287,medium-high-risk
87995,16,110,153,279,medium-high-risk
87997,34,91,152,277,medium-high-risk
88001,0,0,0,0,low-risk
88004,0,0,0,0,low-risk
88009,0,0,0,0,low-risk
8801,12,116,164,292,medium-high-risk
88014,27,119,146,292,medium-high-risk
88017,19,115,164,298,medium-high-risk
88020,0,0,0,0,low-risk
88025,0,0,0,0,low-risk
88027,12,123,162,297,medium-high-risk
88029,15,122,158,295,medium-high-risk
88041,12,173,210,395,high-risk
88042,0,0,0,0,low-risk
88049,0,0,0,0,low-risk
88064,12,79,117,208,medium-low-risk
88071,0,0,0,0,low-risk
88076,22,146,205,373,high-risk
88080,12,93,117,222,medium-low-risk
88084,12,145,223,380,high-risk
88088,0,0,0,0,low-risk
8809,0,0,0,0,low-risk
88109,0,0,0,0,low-risk
88122,36,149,212,397,high-risk
88124,12,144,166,322,medium-high-risk
88126,12,126,232,370,high-risk
88146,0,0,0,0,low-risk
88148,13,95,118,226,medium-low-risk
8815,40,119,166,325,medium-high-risk
88151,27,164,209,400,high-risk
88155,12,132,158,302,medium-high-risk
88170,0,0,0,0,low-risk
88188,12,168,197,377,high-risk
88189,34,140,165,339,high-risk
88192,0,0,0,0,low-risk
88203,12,167,227,406,high-risk
88204,0,0,0,0,low-risk
88219,0,0,0,0,low-risk
88239,0,0,0,0,low-risk
88244,28,130,243,401,high-risk
88245,17,100,150,267,medium-high-risk
8825,0,0,0,0,low-risk
88253,0,0,0,0,low-risk
88255,0,0,0,0,low-risk
88257,0,0,0,0,low-risk
88266,12,122,141,275,medium-high-risk
88267,12,130,214,356,high-risk
88281,13,130,221,364,high-risk
88283,12,152,220,384,high-risk
88284,12,139,188,339,high-risk
88298,12,173,209,394,high-risk
8830,0,0,0,0,low-risk
88301,12,107,145,264,medium-high-risk
88314,12,142,169,323,medium-high-risk
88315,13,158,172,343,high-risk
88316,12,120,165,297,medium-high-risk
88339,26,160,207,393,high-risk
88344,0,0,0,0,low-risk
88345,0,0,0,0,low-risk
88350,58,181,263,502,high-risk
88363,12,73,84,169,medium-low-risk
88371,29,115,146,290,medium-high-risk
88373,12,126,173,311,medium-high-risk
88374,0,0,0,0,low-risk
88378,0,0,0,0,low-risk
88384,0,0,0,0,low-risk
88385,23,100,152,275,medium-high-risk
88389,32,152,206,390,high-risk
88390,12,113,151,276,medium-high-risk
88391,0,0,0,0,low-risk
88403,0,0,0,0,low-risk
88410,35,135,195,365,high-risk
88411,12,154,188,354,high-risk
88412,12,151,168,331,high-risk
88416,0,0,0,0,low-risk
88418,0,0,0,0,low-risk
88429,12,135,178,325,medium-high-risk
88436,0,0,0,0,low-risk
88448,14,102,153,269,medium-high-risk
88462,0,0,0,0,low-risk
8847,0,0,0,0,low-risk
88477,12,130,211,353,high-risk
88481,24,95,139,258,medium-high-risk
88491,0,0,0,0,low-risk
88494,37,140,212,389,high-risk
88519,0,0,0,0,low-risk
88526,0,0,0,0,low-risk
88528,13,118,163,294,medium-high-risk
88539,0,0,0,0,low-risk
88540,12,95,189,296,medium-high-risk
88554,12,95,142,249,medium-high-risk
88555,12,177,203,392,high-risk
88558,12,93,194,299,medium-high-risk
88560,12,105,145,262,medium-high-risk
88564,0,0,0,0,low-risk
88568,0,0,0,0,low-risk
88569,18,90,196,304,medium-high-risk
88580,0,0,0,0,low-risk
88582,12,131,210,353,high-risk
88583,0,0,0,0,low-risk
88594,29,147,185,361,high-risk
88598,24,152,197,373,high-risk
88603,20,105,131,256,medium-high-risk
88630,0,0,0,0,low-risk
88633,0,0,0,0,low-risk
88637,25,155,234,414,high-risk
8864,12,87,130,229,medium-low-risk
8865,0,0,0,0,low-risk
88664,25,103,143,271,medium-high-risk
88673,50,147,203,400,high-risk
88676,15,144,186,345,high-risk
88678,20,106,149,275,medium-high-risk
88687,0,0,0,0,low-risk
88697,26,105,165,296,medium-high-risk
88698,12,116,149,277,medium-high-risk
88700,12,143,158,313,medium-high-risk
88704,0,0,0,0,low-risk
88706,11,84,88,183,medium-low-risk
88707,17,84,128,229,medium-low-risk
88709,12,125,140,277,medium-high-risk
88710,39,155,199,393,high-risk
88721,36,144,182,362,high-risk
88729,12,123,149,284,medium-high-risk
88746,12,127,230,369,high-risk
88754,12,126,161,299,medium-high-risk
88757,0,0,0,0,low-risk
88761,12,139,170,321,medium-high-risk
88769,0,0,0,0,low-risk
88786,0,0,0,0,low-risk
88795,0,0,0,0,low-risk
8880,14,131,227,372,high-risk
88816,0,0,0,0,low-risk
8882,11,118,159,288,medium-high-risk
88821,12,98,144,254,medium-high-risk
88830,0,0,0,0,low-risk
88837,12,151,168,331,high-risk
88846,34,167,229,430,high-risk
88853,0,0,0,0,low-risk
88855,0,0,0,0,low-risk
88859,12,186,295,493,high-risk
88860,18,116,155,289,medium-high-risk
88862,30,131,174,335,high-risk
88863,12,146,229,387,high-risk
88873,12,115,157,284,medium-high-risk
88875,14,118,164,296,medium-high-risk
88876,14,101,137,252,medium-high-risk
88879,27,103,148,278,medium-high-risk
88885,0,0,0,0,low-risk
88898,0,0,0,0,low-risk
88908,0,0,0,0,low-risk
8891,0,0,0,0,low-risk
88926,0,0,0,0,low-risk
88936,0,0,0,0,low-risk
88944,12,133,157,302,medium-high-risk
88957,12,150,188,350,high-risk
88964,0,0,0,0,low-risk
88971,0,0,0,0,low-risk
88987,12,144,191,347,high-risk
88992,12,176,192,380,high-risk
88996,14,126,233,373,high-risk
89001,0,0,0,0,low-risk
89042,0,0,0,0,low-risk
89046,0,0,0,0,low-risk
89049,0,0,0,0,low-risk
89050,12,121,159,292,medium-high-risk
8906,15,134,197,346,high-risk
89060,0,0,0,0,low-risk
89061,17,188,291,496,high-risk
89064,12,139,163,314,medium-high-risk
8907,12,91,131,234,medium-low-risk
89073,12,125,74,211,medium-low-risk
89094,20,140,197,357,high-risk
89112,12,120,195,327,medium-high-risk
89118,0,0,0,0,low-risk
89126,15,112,163,290,medium-high-risk
89127,0,0,0,0,low-risk
8913,0,0,0,0,low-risk
89140,12,144,164,320,medium-high-risk
89141,12,95,190,297,medium-high-risk
89157,0,0,0,0,low-risk
89173,12,124,145,281,medium-high-risk
89175,12,105,169,286,medium-high-risk
89181,0,0,0,0,low-risk
89184,15,132,216,363,high-risk
89187,0,0,0,0,low-risk
8919,12,131,158,301,medium-high-risk
89190,0,0,0,0,low-risk
89203,0,0,0,0,low-risk
89210,12,116,121,249,medium-high-risk
89213,12,165,226,403,high-risk
89215,19,170,233,422,high-risk
89222,0,0,0,0,low-risk
89227,0,0,0,0,low-risk
89229,0,0,0,0,low-risk
89249,15,80,129,224,medium-low-risk
89259,0,0,0,0,low-risk
89264,0,0,0,0,low-risk
89265,0,0,0,0,low-risk
89288,0,0,0,0,low-risk
89289,0,0,0,0,low-risk
89294,13,99,143,255,medium-high-risk
8930,0,0,0,0,low-risk
89301,12,127,163,302,medium-high-risk
89305,23,133,202,358,high-risk
8934,0,0,0,0,low-risk
89341,0,0,0,0,low-risk
89350,12,156,294,462,high-risk
89369,0,0,0,0,low-risk
89375,0,0,0,0,low-risk
89384,0,0,0,0,low-risk
89386,0,0,0,0,low-risk
89393,12,149,179,340,high-risk
89399,14,181,211,406,high-risk
89410,0,0,0,0,low-risk
89428,0,0,0,0,low-risk
8943,24,109,177,310,medium-high-risk
89440,0,0,0,0,low-risk
89446,0,0,0,0,low-risk
89451,32,155,243,430,high-risk
89455,42,115,183,340,high-risk
89459,13,119,150,282,medium-high-risk
89461,12,140,225,377,high-risk
89463,0,0,0,0,low-risk
8947,12,103,148,263,medium-high-risk
89470,0,0,0,0,low-risk
89477,0,0,0,0,low-risk
89478,12,117,135,264,medium-high-risk
89485,12,154,164,330,high-risk
89487,12,107,135,254,medium-high-risk
89512,12,98,191,301,medium-high-risk
89517,64,186,242,492,high-risk
89523,0,0,0,0,low-risk
89525,12,134,158,304,medium-high-risk
89530,12,138,161,311,medium-high-risk
89534,0,0,0,0,low-risk
89542,12,116,150,278,medium-high-risk
89545,13,130,187,330,high-risk
89570,0,0,0,0,low-risk
89577,0,0,0,0,low-risk
89585,19,87,136,242,medium-low-risk
89586,0,0,0,0,low-risk
89594,25,121,201,347,high-risk
89596,38,113,170,321,medium-high-risk
89599,15,152,270,437,high-risk
89600,0,0,0,0,low-risk
89603,12,106,155,273,medium-high-risk
89619,24,134,187,345,high-risk
89625,12,128,177,317,medium-high-risk
89631,12,117,179,308,medium-high-risk
89632,0,0,0,0,low-risk
89635,0,0,0,0,low-risk
89637,12,147,159,318,medium-high-risk
89638,12,162,197,371,high-risk
8964,0,0,0,0,low-risk
89640,0,0,0,0,low-risk
89644,0,0,0,0,low-risk
89659,11,89,122,222,medium-low-risk
8966,0,0,0,0,low-risk
89660,12,126,170,308,medium-high-risk
89665,0,0,0,0,low-risk
89673,12,149,172,333,high-risk
8968,28,120,282,430,high-risk
89683,0,0,0,0,low-risk
89685,0,0,0,0,low-risk
89698,12,143,213,368,high-risk
89702,0,0,0,0,low-risk
8971,0,0,0,0,low-risk
89713,0,0,0,0,low-risk
89719,14,96,135,245,medium-high-risk
89728,12,137,187,336,high-risk
89756,12,152,335,499,high-risk
89759,0,0,0,0,low-risk
89770,36,154,196,386,high-risk
89771,12,142,161,315,medium-high-risk
89773,0,0,0,0,low-risk
8978,0,0,0,0,low-risk
89785,0,0,0,0,low-risk
89789,0,0,0,0,low-risk
8982,12,94,118,224,medium-low-risk
89829,0,0,0,0,low-risk
89830,30,109,167,306,medium-high-risk
89833,12,160,197,369,high-risk
8984,0,0,0,0,low-risk
89847,12,100,138,250,medium-high-risk
89848,0,0,0,0,low-risk
89850,0,0,0,0,low-risk
89853,12,66,128,206,medium-low-risk
89872,0,0,0,0,low-risk
89889,20,106,140,266,medium-high-risk
89920,12,120,159,291,medium-high-risk
89922,0,0,0,0,low-risk
89926,0,0,0,0,low-risk
8994,12,110,145,267,medium-high-risk
89944,12,91,132,235,medium-low-risk
89957,18,67,132,217,medium-low-risk
89958,0,0,0,0,low-risk
8996,0,0,0,0,low-risk
89962,0,0,0,0,low-risk
89967,12,179,394,585,high-risk
89974,12,124,241,377,high-risk
8998,0,0,0,0,low-risk
89980,13,172,254,439,high-risk
89982,12,142,171,325,medium-high-risk
89984,27,129,158,314,medium-high-risk
89985,14,103,137,254,medium-high-risk
89993,12,135,183,330,high-risk
89995,0,0,0,0,low-risk
89996,0,0,0,0,low-risk
89999,0,0,0,0,low-risk
90019,0,0,0,0,low-risk
90028,16,149,236,401,high-risk
9003,0,0,0,0,low-risk
90039,0,0,0,0,low-risk
90045,40,114,186,340,high-risk
90048,0,0,0,0,low-risk
9005,0,0,0,0,low-risk
90057,0,0,0,0,low-risk
90066,0,0,0,0,low-risk
90068,17,155,212,384,high-risk
90077,16,126,180,322,medium-high-risk
90083,12,77,106,195,medium-low-risk
90092,0,0,0,0,low-risk
90098,14,93,137,244,medium-low-risk
90102,0,0,0,0,low-risk
90105,15,150,297,462,high-risk
90147,12,157,190,359,high-risk
9015,0,0,0,0,low-risk
90150,0,0,0,0,low-risk
90153,17,105,162,284,medium-high-risk
90159,0,0,0,0,low-risk
90176,28,138,157,323,medium-high-risk
90179,0,0,0,0,low-risk
90184,0,0,0,0,low-risk
90187,0,0,0,0,low-risk
90189,0,0,0,0,low-risk
90204,0,0,0,0,low-risk
90213,0,0,0,0,low-risk
90215,0,0,0,0,low-risk
90218,17,123,165,305,medium-high-risk
9022,39,149,201,389,high-risk
90226,0,0,0,0,low-risk
9025,0,0,0,0,low-risk
90269,37,133,214,384,high-risk
9027,0,0,0,0,low-risk
90274,0,0,0,0,low-risk
90276,16,147,273,436,high-risk
9029,12,148,125,285,medium-high-risk
90294,0,0,0,0,low-risk
9030,24,119,157,300,medium-high-risk
90304,26,164,211,401,high-risk
90305,0,0,0,0,low-risk
90311,30,130,170,330,high-risk
90315,0,0,0,0,low-risk
90324,0,0,0,0,low-risk
90325,0,0,0,0,low-risk
90330,12,164,204,380,high-risk
90333,0,0,0,0,low-risk
90334,12,110,127,249,medium-high-risk
90346,0,0,0,0,low-risk
90348,0,0,0,0,low-risk
90349,12,135,178,325,medium-high-risk
90352,12,116,169,297,medium-high-risk
90355,0,0,0,0,low-risk
90357,15,118,196,329,medium-high-risk
90365,0,0,0,0,low-risk
90370,0,0,0,0,low-risk
90372,0,0,0,0,low-risk
90388,15,134,182,331,high-risk
90392,0,0,0,0,low-risk
90400,26,110,146,282,medium-high-risk
90404,0,0,0,0,low-risk
90408,11,168,386,565,high-risk
90409,22,119,207,348,high-risk
9041,19,173,221,413,high-risk
90411,0,0,0,0,low-risk
90413,0,0,0,0,low-risk
90419,0,0,0,0,low-risk
90430,0,0,0,0,low-risk
90435,12,99,182,293,medium-high-risk
90442,0,0,0,0,low-risk
90448,12,120,188,320,medium-high-risk
90475,0,0,0,0,low-risk
9048,12,143,226,381,high-risk
90482,12,84,107,203,medium-low-risk
90492,12,124,171,307,medium-high-risk
90502,12,187,219,418,high-risk
90505,12,139,298,449,high-risk
90512,25,113,174,312,medium-high-risk
90516,0,0,0,0,low-risk
90524,13,140,237,390,high-risk
90527,0,0,0,0,low-risk
90533,38,118,160,316,medium-high-risk
90545,0,0,0,0,low-risk
9055,0,0,0,0,low-risk
90550,13,205,279,497,high-risk
90561,12,121,136,269,medium-high-risk
90563,12,66,100,178,medium-low-risk
90574,19,135,156,310,medium-high-risk
90576,12,119,165,296,medium-high-risk
90601,12,130,92,234,medium-low-risk
90610,0,0,0,0,low-risk
90613,15,165,344,524,high-risk
90619,0,0,0,0,low-risk
90620,14,149,251,414,high-risk
90635,0,0,0,0,low-risk
90638,20,93,173,286,medium-high-risk
9064,0,0,0,0,low-risk
90641,0,0,0,0,low-risk
90650,14,132,187,333,high-risk
90658,0,0,0,0,low-risk
90679,0,0,0,0,low-risk
90681,12,198,231,441,high-risk
90683,0,0,0,0,low-risk
90684,12,105,149,266,medium-high-risk
90688,0,0,0,0,low-risk
90689,12,122,133,267,medium-high-risk
90693,0,0,0,0,low-risk
9070,0,0,0,0,low-risk
90709,0,0,0,0,low-risk
90711,12,163,214,389,high-risk
90714,12,115,183,310,medium-high-risk
90715,12,167,230,409,high-risk
90728,23,139,222,384,high-risk
90733,0,0,0,0,low-risk
9074,0,0,0,0,low-risk
90745,13,153,191,357,high-risk
90747,0,0,0,0,low-risk
90749,16,109,145,270,medium-high-risk
9075,12,119,129,260,medium-high-risk
90751,12,129,146,287,medium-high-risk
90752,28,184,237,449,high-risk
90756,21,100,154,275,medium-high-risk
90758,0,0,0,0,low-risk
9076,12,88,124,224,medium-low-risk
90764,22,146,181,349,high-risk
90768,17,130,176,323,medium-high-risk
90771,0,0,0,0,low-risk
90781,12,136,131,279,medium-high-risk
90783,12,162,172,346,high-risk
90784,15,140,217,372,high-risk
90786,0,0,0,0,low-risk
90795,0,0,0,0,low-risk
90796,0,0,0,0,low-risk
90797,0,0,0,0,low-risk
90817,37,112,225,374,high-risk
90819,0,0,0,0,low-risk
90822,12,90,126,228,medium-low-risk
90827,0,0,0,0,low-risk
90829,28,113,154,295,medium-high-risk
90830,12,136,139,287,medium-high-risk
90831,33,161,257,451,high-risk
90835,0,0,0,0,low-risk
90838,16,143,183,342,high-risk
90840,27,132,169,328,medium-high-risk
90845,0,0,0,0,low-risk
90847,15,131,187,333,high-risk
90852,0,0,0,0,low-risk
90861,27,105,148,280,medium-high-risk
90869,48,140,176,364,high-risk
90870,0,0,0,0,low-risk
90877,25,86,171,282,medium-high-risk
9088,14,141,234,389,high-risk
9089,0,0,0,0,low-risk
90898,48,155,225,428,high-risk
90903,34,158,303,495,high-risk
90907,0,0,0,0,low-risk
90910,23,104,147,274,medium-high-risk
90916,18,84,127,229,medium-low-risk
90923,12,157,211,380,high-risk
90927,0,0,0,0,low-risk
90931,12,93,136,241,medium-low-risk
90932,0,0,0,0,low-risk
90952,0,0,0,0,low-risk
90958,12,206,120,338,high-risk
90963,14,102,146,262,medium-high-risk
90964,0,0,0,0,low-risk
90965,0,0,0,0,low-risk
90975,0,0,0,0,low-risk
90978,0,0,0,0,low-risk
90980,0,0,0,0,low-risk
90995,0,0,0,0,low-risk
90997,0,0,0,0,low-risk
91009,0,0,0,0,low-risk
91010,18,148,193,359,high-risk
91014,29,111,165,305,medium-high-risk
91019,0,0,0,0,low-risk
91035,16,94,112,222,medium-low-risk
91043,0,0,0,0,low-risk
91045,0,0,0,0,low-risk
91049,0,0,0,0,low-risk
91052,0,0,0,0,low-risk
91054,35,119,153,307,medium-high-risk
91055,12,121,150,283,medium-high-risk
91067,0,0,0,0,low-risk
91069,12,154,97,263,medium-high-risk
91091,12,164,239,415,high-risk
91096,45,158,187,390,high-risk
91107,38,137,193,368,high-risk
91109,0,0,0,0,low-risk
91110,19,116,198,333,high-risk
91124,12,113,235,360,high-risk
91134,12,147,196,355,high-risk
91145,12,147,211,370,high-risk
91147,29,99,142,270,medium-high-risk
91151,26,105,130,261,medium-high-risk
91157,0,0,0,0,low-risk
91169,34,140,234,408,high-risk
9117,0,0,0,0,low-risk
91172,12,100,120,232,medium-low-risk
91174,12,127,169,308,medium-high-risk
91186,12,192,211,415,high-risk
91189,12,103,150,265,medium-high-risk
9119,0,0,0,0,low-risk
9120,12,171,217,400,high-risk
91202,34,136,154,324,medium-high-risk
91212,18,157,213,388,high-risk
91220,0,0,0,0,low-risk
91224,0,0,0,0,low-risk
91228,0,0,0,0,low-risk
91230,12,83,119,214,medium-low-risk
91238,13,90,128,231,medium-low-risk
91241,0,0,0,0,low-risk
91245,41,135,191,367,high-risk
91246,0,0,0,0,low-risk
91252,12,119,175,306,medium-high-risk
91253,27,122,176,325,medium-high-risk
91254,0,0,0,0,low-risk
91258,12,121,155,288,medium-high-risk
91261,40,145,188,373,high-risk
91264,12,137,182,331,high-risk
91268,26,124,181,331,high-risk
91276,12,120,152,284,medium-high-risk
91294,12,152,174,338,high-risk
91305,12,135,148,295,medium-high-risk
91307,0,0,0,0,low-risk
91324,12,130,151,293,medium-high-risk
9133,12,130,191,333,high-risk
91338,12,103,123,238,medium-low-risk
91344,0,0,0,0,low-risk
91350,0,0,0,0,low-risk
91357,0,0,0,0,low-risk
91359,13,136,239,388,high-risk
91360,19,157,243,419,high-risk
91364,0,0,0,0,low-risk
91373,0,0,0,0,low-risk
91374,0,0,0,0,low-risk
91384,0,0,0,0,low-risk
91387,45,133,188,366,high-risk
91392,0,0,0,0,low-risk
91393,13,133,162,308,medium-high-risk
91403,12,133,172,317,medium-high-risk
91406,0,0,0,0,low-risk
91407,12,91,198,301,medium-high-risk
91409,12,120,146,278,medium-high-risk
9141,12,128,155,295,medium-high-risk
91421,12,115,162,289,medium-high-risk
91424,0,0,0,0,low-risk
91427,12,147,154,313,medium-high-risk
91431,25,161,207,393,high-risk
91436,15,109,162,286,medium-high-risk
91447,14,112,162,288,medium-high-risk
91456,12,120,153,285,medium-high-risk
91458,0,0,0,0,low-risk
91468,12,128,170,310,medium-high-risk
91485,0,0,0,0,low-risk
91497,0,0,0,0,low-risk
9150,16,73,108,197,medium-low-risk
91503,0,0,0,0,low-risk
91508,22,109,132,263,medium-high-risk
91520,12,150,164,326,medium-high-risk
91522,17,99,145,261,medium-high-risk
91530,0,0,0,0,low-risk
91532,24,116,150,290,medium-high-risk
91538,0,0,0,0,low-risk
91547,0,0,0,0,low-risk
91561,23,119,172,314,medium-high-risk
91570,0,0,0,0,low-risk
91592,0,0,0,0,low-risk
91593,39,90,289,418,high-risk
91601,12,116,166,294,medium-high-risk
91609,17,134,187,338,high-risk
91615,19,80,117,216,medium-low-risk
91618,14,116,208,338,high-risk
9162,12,154,178,344,high-risk
91625,12,128,163,303,medium-high-risk
91626,19,89,161,269,medium-high-risk
91627,12,118,142,272,medium-high-risk
91633,0,0,0,0,low-risk
91641,21,126,171,318,medium-high-risk
9165,0,0,0,0,low-risk
91652,0,0,0,0,low-risk
91655,12,113,133,258,medium-high-risk
91660,11,119,132,262,medium-high-risk
91665,33,161,220,414,high-risk
91672,12,133,162,307,medium-high-risk
91684,14,87,117,218,medium-low-risk
91686,12,129,158,299,medium-high-risk
91695,12,140,100,252,medium-high-risk
9171,0,0,0,0,low-risk
91710,0,0,0,0,low-risk
91719,12,109,146,267,medium-high-risk
9172,25,82,129,236,medium-low-risk
9173,25,123,170,318,medium-high-risk
91733,12,122,171,305,medium-high-risk
91736,0,0,0,0,low-risk
91741,40,109,145,294,medium-high-risk
91748,12,164,178,354,high-risk
91749,12,106,137,255,medium-high-risk
91760,24,188,254,466,high-risk
91761,26,144,173,343,high-risk
91765,0,0,0,0,low-risk
9177,0,0,0,0,low-risk
91776,0,0,0,0,low-risk
91777,0,0,0,0,low-risk
91787,0,0,0,0,low-risk
91788,11,146,154,311,medium-high-risk
91789,28,144,190,362,high-risk
91792,12,167,189,368,high-risk
91795,15,100,138,253,medium-high-risk
91816,0,0,0,0,low-risk
91819,12,100,105,217,medium-low-risk
91830,0,0,0,0,low-risk
91835,12,140,96,248,medium-high-risk
91844,12,110,124,246,medium-high-risk
91858,21,73,116,210,medium-low-risk
9186,34,152,182,368,high-risk
91862,0,0,0,0,low-risk
91866,0,0,0,0,low-risk
9189,16,152,223,391,high-risk
91890,17,129,164,310,medium-high-risk
91906,26,137,167,330,high-risk
91907,0,0,0,0,low-risk
91908,38,157,192,387,high-risk
91910,0,0,0,0,low-risk
91916,17,108,138,263,medium-high-risk
91917,0,0,0,0,low-risk
91919,15,130,176,321,medium-high-risk
91943,0,0,0,0,low-risk
91946,0,0,0,0,low-risk
91950,0,0,0,0,low-risk
91956,0,0,0,0,low-risk
91963,0,0,0,0,low-risk
91964,12,162,199,373,high-risk
91973,0,0,0,0,low-risk
91980,0,0,0,0,low-risk
91987,12,172,192,376,high-risk
91990,0,0,0,0,low-risk
91996,16,119,157,292,medium-high-risk
92000,0,0,0,0,low-risk
92006,0,0,0,0,low-risk
92016,0,0,0,0,low-risk
92018,11,82,112,205,medium-low-risk
92029,0,0,0,0,low-risk
92030,12,135,178,325,medium-high-risk
92034,0,0,0,0,low-risk
9204,12,116,162,290,medium-high-risk
92041,0,0,0,0,low-risk
92043,0,0,0,0,low-risk
92044,0,0,0,0,low-risk
92045,31,115,177,323,medium-high-risk
92058,0,0,0,0,low-risk
92060,0,0,0,0,low-risk
92061,13,133,161,307,medium-high-risk
92067,12,100,116,228,medium-low-risk
92074,0,0,0,0,low-risk
92091,12,175,209,396,high-risk
92097,20,113,170,303,medium-high-risk
92113,12,129,141,282,medium-high-risk
92120,0,0,0,0,low-risk
92137,0,0,0,0,low-risk
92143,0,0,0,0,low-risk
92149,0,0,0,0,low-risk
92152,0,0,0,0,low-risk
92154,12,98,141,251,medium-high-risk
92165,12,103,145,260,medium-high-risk
92172,27,142,177,346,high-risk
92174,12,95,111,218,medium-low-risk
92175,30,135,184,349,high-risk
9218,13,90,103,206,medium-low-risk
92185,12,68,123,203,medium-low-risk
92189,0,0,0,0,low-risk
92196,0,0,0,0,low-risk
9220,0,0,0,0,low-risk
92205,12,155,164,331,high-risk
92209,14,96,122,232,medium-low-risk
92210,12,142,163,317,medium-high-risk
92226,12,136,87,235,medium-low-risk
92229,12,127,216,355,high-risk
92235,0,0,0,0,low-risk
92237,12,114,132,258,medium-high-risk
9225,12,99,110,221,medium-low-risk
92251,0,0,0,0,low-risk
92253,13,117,164,294,medium-high-risk
92255,0,0,0,0,low-risk
92258,0,0,0,0,low-risk
92265,12,114,160,286,medium-high-risk
92278,16,161,193,370,high-risk
92280,0,0,0,0,low-risk
92283,34,185,270,489,high-risk
92284,17,90,135,242,medium-low-risk
92290,0,0,0,0,low-risk
92296,16,79,190,285,medium-high-risk
92301,0,0,0,0,low-risk
92310,0,0,0,0,low-risk
92319,0,0,0,0,low-risk
92325,12,109,133,254,medium-high-risk
92327,0,0,0,0,low-risk
92336,12,116,148,276,medium-high-risk
92337,0,0,0,0,low-risk
92346,23,140,288,451,high-risk
92351,51,231,342,624,high-risk
92356,12,72,117,201,medium-low-risk
92357,0,0,0,0,low-risk
9236,0,0,0,0,low-risk
92367,0,0,0,0,low-risk
92368,0,0,0,0,low-risk
92386,12,92,120,224,medium-low-risk
9239,12,110,226,348,high-risk
92394,0,0,0,0,low-risk
92396,34,141,163,338,high-risk
92398,0,0,0,0,low-risk
92399,12,116,165,293,medium-high-risk
9240,0,0,0,0,low-risk
92404,0,0,0,0,low-risk
92413,12,83,129,224,medium-low-risk
92415,35,131,164,330,high-risk
92416,12,117,148,277,medium-high-risk
92420,0,0,0,0,low-risk
92428,12,81,127,220,medium-low-risk
92430,29,167,219,415,high-risk
92463,52,179,217,448,high-risk
92468,12,111,165,288,medium-high-risk
92469,12,115,144,271,medium-high-risk
92470,0,0,0,0,low-risk
92478,0,0,0,0,low-risk
92485,14,91,124,229,medium-low-risk
92488,12,118,160,290,medium-high-risk
92492,0,0,0,0,low-risk
92497,0,0,0,0,low-risk
92498,19,169,207,395,high-risk
92499,15,152,157,324,medium-high-risk
9250,12,91,126,229,medium-low-risk
92503,0,0,0,0,low-risk
92506,12,101,135,248,medium-high-risk
92518,0,0,0,0,low-risk
92524,13,99,113,225,medium-low-risk
92527,24,104,152,280,medium-high-risk
92530,0,0,0,0,low-risk
92534,0,0,0,0,low-risk
92535,0,0,0,0,low-risk
9254,0,0,0,0,low-risk
92540,17,115,132,264,medium-high-risk
9255,13,162,211,386,high-risk
92551,28,113,158,299,medium-high-risk
92552,12,119,157,288,medium-high-risk
92554,0,0,0,0,low-risk
9256,16,69,120,205,medium-low-risk
92562,0,0,0,0,low-risk
92566,12,176,197,385,high-risk
9259,0,0,0,0,low-risk
92591,11,99,114,224,medium-low-risk
92601,34,144,183,361,high-risk
92603,14,61,98,173,medium-low-risk
92610,12,94,177,283,medium-high-risk
92611,0,0,0,0,low-risk
92614,12,165,237,414,high-risk
9262,13,144,160,317,medium-high-risk
92620,0,0,0,0,low-risk
92626,35,148,205,388,high-risk
92631,12,120,172,304,medium-high-risk
92633,12,122,158,292,medium-high-risk
92635,33,117,170,320,medium-high-risk
92639,12,130,184,326,medium-high-risk
92649,12,146,191,349,high-risk
92667,12,91,105,208,medium-low-risk
9267,37,178,230,445,high-risk
92675,17,109,169,295,medium-high-risk
92680,0,0,0,0,low-risk
92692,44,121,155,320,medium-high-risk
92693,24,138,188,350,high-risk
92696,12,129,152,293,medium-high-risk
92703,0,0,0,0,low-risk
92704,0,0,0,0,low-risk
92705,12,121,162,295,medium-high-risk
92710,44,140,167,351,high-risk
92715,40,165,226,431,high-risk
92721,13,110,164,287,medium-high-risk
92738,0,0,0,0,low-risk
92749,0,0,0,0,low-risk
92768,12,133,147,292,medium-high-risk
92770,0,0,0,0,low-risk
92773,0,0,0,0,low-risk
92774,12,103,137,252,medium-high-risk
92775,55,225,238,518,high-risk
92777,18,85,126,229,medium-low-risk
92778,12,150,173,335,high-risk
92785,18,194,274,486,high-risk
92793,12,85,107,204,medium-low-risk
92811,0,0,0,0,low-risk
92813,17,91,136,244,medium-low-risk
92830,12,134,154,300,medium-high-risk
92848,14,101,167,282,medium-high-risk
92852,13,143,170,326,medium-high-risk
9287,0,0,0,0,low-risk
92882,39,195,262,496,high-risk
92892,41,122,409,572,high-risk
92915,0,0,0,0,low-risk
92918,12,120,143,275,medium-high-risk
92920,12,192,229,433,high-risk
92924,0,0,0,0,low-risk
92925,12,123,166,301,medium-high-risk
92936,12,135,164,311,medium-high-risk
92943,12,131,178,321,medium-high-risk
92945,12,146,197,355,high-risk
92957,0,0,0,0,low-risk
92959,59,283,525,867,high-risk
92970,28,193,182,403,high-risk
92973,12,93,121,226,medium-low-risk
92977,13,87,125,225,medium-low-risk
92998,12,139,168,319,medium-high-risk
9300,12,123,184,319,medium-high-risk
93012,19,125,166,310,medium-high-risk
93024,12,96,167,275,medium-high-risk
93025,50,138,214,402,high-risk
9303,12,103,140,255,medium-high-risk
93038,0,0,0,0,low-risk
9304,0,0,0,0,low-risk
93051,12,109,138,259,medium-high-risk
93068,0,0,0,0,low-risk
9307,0,0,0,0,low-risk
93083,12,138,155,305,medium-high-risk
93085,0,0,0,0,low-risk
93095,17,101,145,263,medium-high-risk
93097,0,0,0,0,low-risk
93104,0,0,0,0,low-risk
93116,0,0,0,0,low-risk
9312,0,0,0,0,low-risk
93126,0,0,0,0,low-risk
9313,0,0,0,0,low-risk
9314,0,0,0,0,low-risk
93144,18,80,112,210,medium-low-risk
93156,0,0,0,0,low-risk
93163,0,0,0,0,low-risk
93164,0,0,0,0,low-risk
93167,16,89,126,231,medium-low-risk
93176,15,149,191,355,high-risk
93177,14,95,126,235,medium-low-risk
93178,12,170,215,397,high-risk
93187,13,119,169,301,medium-high-risk
93199,0,0,0,0,low-risk
93215,15,135,232,382,high-risk
93216,0,0,0,0,low-risk
93222,0,0,0,0,low-risk
93228,12,155,190,357,high-risk
9323,12,117,132,261,medium-high-risk
93241,12,176,212,400,high-risk
93247,0,0,0,0,low-risk
93268,0,0,0,0,low-risk
93277,0,0,0,0,low-risk
93283,16,153,196,365,high-risk
93303,8,109,250,367,high-risk
93313,12,158,194,364,high-risk
93325,0,0,0,0,low-risk
9333,12,120,212,344,high-risk
93333,12,111,161,284,medium-high-risk
93350,0,0,0,0,low-risk
9337,12,71,98,181,medium-low-risk
93372,34,199,296,529,high-risk
93375,12,106,143,261,medium-high-risk
93399,58,119,195,372,high-risk
93401,12,77,128,217,medium-low-risk
93407,12,144,289,445,high-risk
9341,27,159,207,393,high-risk
93420,12,99,162,273,medium-high-risk
93421,0,0,0,0,low-risk
93426,12,96,140,248,medium-high-risk
93451,0,0,0,0,low-risk
93457,0,0,0,0,low-risk
93458,12,143,236,391,high-risk
93467,0,0,0,0,low-risk
93469,0,0,0,0,low-risk
9347,18,102,215,335,high-risk
93492,12,100,87,199,medium-low-risk
93498,0,0,0,0,low-risk
93504,0,0,0,0,low-risk
93514,19,95,132,246,medium-high-risk
93517,0,0,0,0,low-risk
93522,12,155,175,342,high-risk
93528,12,154,305,471,high-risk
93530,23,183,313,519,high-risk
93549,0,0,0,0,low-risk
9356,0,0,0,0,low-risk
93563,0,0,0,0,low-risk
9357,0,0,0,0,low-risk
93581,0,0,0,0,low-risk
93588,45,159,313,517,high-risk
93589,0,0,0,0,low-risk
9359,0,0,0,0,low-risk
9360,29,156,182,367,high-risk
93600,0,0,0,0,low-risk
93608,39,161,192,392,high-risk
93614,15,167,253,435,high-risk
93624,12,164,216,392,high-risk
93629,0,0,0,0,low-risk
93646,0,0,0,0,low-risk
93650,0,0,0,0,low-risk
93653,12,119,150,281,medium-high-risk
93656,25,152,193,370,high-risk
93658,37,144,191,372,high-risk
93662,0,0,0,0,low-risk
93665,12,103,141,256,medium-high-risk
93678,14,156,311,481,high-risk
93680,12,152,172,336,high-risk
93683,12,111,148,271,medium-high-risk
93692,12,164,203,379,high-risk
93694,12,102,134,248,medium-high-risk
93715,0,0,0,0,low-risk
93720,0,0,0,0,low-risk
93728,0,0,0,0,low-risk
9374,0,0,0,0,low-risk
93747,0,0,0,0,low-risk
93765,19,99,148,266,medium-high-risk
93771,34,111,144,289,medium-high-risk
93782,12,82,122,216,medium-low-risk
93783,0,0,0,0,low-risk
93787,13,112,155,280,medium-high-risk
93790,21,107,151,279,medium-high-risk
93798,0,0,0,0,low-risk
9381,41,156,230,427,high-risk
93820,0,0,0,0,low-risk
93823,0,0,0,0,low-risk
93827,27,170,210,407,high-risk
93840,0,0,0,0,low-risk
93841,12,140,228,380,high-risk
93850,26,108,157,291,medium-high-risk
93855,0,0,0,0,low-risk
93862,31,141,178,350,high-risk
93866,14,155,238,407,high-risk
93867,14,79,122,215,medium-low-risk
9387,0,0,0,0,low-risk
93870,14,131,177,322,medium-high-risk
93871,19,157,238,414,high-risk
93876,0,0,0,0,low-risk
93881,0,0,0,0,low-risk
93884,16,113,176,305,medium-high-risk
93892,0,0,0,0,low-risk
93893,22,94,144,260,medium-high-risk
93905,0,0,0,0,low-risk
93916,0,0,0,0,low-risk
93932,12,98,147,257,medium-high-risk
93938,0,0,0,0,low-risk
9395,0,0,0,0,low-risk
93952,30,168,256,454,high-risk
93963,0,0,0,0,low-risk
93968,0,0,0,0,low-risk
93971,30,127,175,332,high-risk
93977,0,0,0,0,low-risk
93980,0,0,0,0,low-risk
93982,0,0,0,0,low-risk
9399,49,185,277,511,high-risk
93990,12,103,150,265,medium-high-risk
93992,20,87,124,231,medium-low-risk
94002,12,149,184,345,high-risk
94012,12,153,217,382,high-risk
94025,12,143,239,394,high-risk
94032,12,150,181,343,high-risk
94040,0,0,0,0,low-risk
9405,0,0,0,0,low-risk
94054,12,150,221,383,high-risk
9407,50,148,193,391,high-risk
94072,12,120,211,343,high-risk
94079,26,116,179,321,medium-high-risk
94083,0,0,0,0,low-risk
94086,0,0,0,0,low-risk
94088,23,120,170,313,medium-high-risk
94089,0,0,0,0,low-risk
94090,12,127,179,318,medium-high-risk
94092,0,0,0,0,low-risk
9410,0,0,0,0,low-risk
94104,0,0,0,0,low-risk
94118,0,0,0,0,low-risk
94129,0,0,0,0,low-risk
94130,12,89,127,228,medium-low-risk
94142,12,166,194,372,high-risk
94152,17,80,150,247,medium-high-risk
94153,12,96,123,231,medium-low-risk
94157,12,98,142,252,medium-high-risk
9416,0,0,0,0,low-risk
94164,19,145,201,365,high-risk
94171,12,95,133,240,medium-low-risk
94172,12,110,132,254,medium-high-risk
94177,12,138,182,332,high-risk
94178,25,178,234,437,high-risk
94180,0,0,0,0,low-risk
94182,12,146,202,360,high-risk
94186,12,159,193,364,high-risk
94200,31,151,203,385,high-risk
94203,0,0,0,0,low-risk
94209,12,135,176,323,medium-high-risk
94210,12,109,123,244,medium-low-risk
94213,12,120,150,282,medium-high-risk
94220,12,158,199,369,high-risk
94226,0,0,0,0,low-risk
94239,0,0,0,0,low-risk
94272,12,135,173,320,medium-high-risk
94308,0,0,0,0,low-risk
94318,49,127,307,483,high-risk
94321,0,0,0,0,low-risk
94323,0,0,0,0,low-risk
94324,12,110,141,263,medium-high-risk
94325,0,0,0,0,low-risk
94328,0,0,0,0,low-risk
94332,12,105,194,311,medium-high-risk
94333,12,99,131,242,medium-low-risk
94342,0,0,0,0,low-risk
94343,12,153,176,341,high-risk
94357,45,191,223,459,high-risk
94358,23,131,177,331,high-risk
94360,0,0,0,0,low-risk
94368,12,133,126,271,medium-high-risk
94374,12,166,183,361,high-risk
94383,0,0,0,0,low-risk
94385,17,72,97,186,medium-low-risk
94388,21,159,239,419,high-risk
94389,0,0,0,0,low-risk
94394,24,160,210,394,high-risk
94400,0,0,0,0,low-risk
94405,0,0,0,0,low-risk
94417,0,0,0,0,low-risk
94420,12,158,197,367,high-risk
94432,25,92,142,259,medium-high-risk
94438,12,110,122,244,medium-low-risk
94441,12,159,207,378,high-risk
94447,0,0,0,0,low-risk
94450,0,0,0,0,low-risk
94462,0,0,0,0,low-risk
94463,22,128,177,327,medium-high-risk
94474,0,0,0,0,low-risk
94487,12,39,66,117,medium-low-risk
94497,12,119,154,285,medium-high-risk
9453,25,123,173,321,medium-high-risk
94532,12,158,228,398,high-risk
94533,0,0,0,0,low-risk
94535,13,117,174,304,medium-high-risk
94542,0,0,0,0,low-risk
94547,22,154,235,411,high-risk
94554,0,0,0,0,low-risk
94555,12,101,121,234,medium-low-risk
94569,13,69,98,180,medium-low-risk
94580,12,103,164,279,medium-high-risk
94587,0,0,0,0,low-risk
94591,0,0,0,0,low-risk
94597,0,0,0,0,low-risk
94598,12,134,175,321,medium-high-risk
9460,12,63,75,150,medium-low-risk
94609,12,149,187,348,high-risk
94621,0,0,0,0,low-risk
94622,0,0,0,0,low-risk
94651,0,0,0,0,low-risk
94652,13,112,215,340,high-risk
94653,0,0,0,0,low-risk
94659,20,158,208,386,high-risk
94665,0,0,0,0,low-risk
94666,12,140,164,316,medium-high-risk
94677,0,0,0,0,low-risk
94684,0,0,0,0,low-risk
94690,0,0,0,0,low-risk
94708,19,109,139,267,medium-high-risk
94732,12,120,125,257,medium-high-risk
94734,0,0,0,0,low-risk
9474,12,186,136,334,high-risk
94744,22,180,244,446,high-risk
9475,0,0,0,0,low-risk
9477,0,0,0,0,low-risk
94780,0,0,0,0,low-risk
94789,0,0,0,0,low-risk
9479,12,132,169,313,medium-high-risk
94794,0,0,0,0,low-risk
94799,12,168,214,394,high-risk
9480,12,151,243,406,high-risk
94802,0,0,0,0,low-risk
94814,0,0,0,0,low-risk
94829,24,87,130,241,medium-low-risk
94833,31,91,258,380,high-risk
94835,12,162,195,369,high-risk
94840,12,121,154,287,medium-high-risk
94848,0,0,0,0,low-risk
94860,0,0,0,0,low-risk
94863,12,84,136,232,medium-low-risk
94877,0,0,0,0,low-risk
94879,34,147,214,395,high-risk
94908,11,133,236,380,high-risk
94923,12,76,92,180,medium-low-risk
94925,13,142,176,331,high-risk
94930,0,0,0,0,low-risk
94941,12,163,178,353,high-risk
94948,12,114,123,249,medium-high-risk
94953,0,0,0,0,low-risk
94958,12,135,187,334,high-risk
94959,33,158,235,426,high-risk
94965,18,108,135,261,medium-high-risk
94975,12,112,146,270,medium-high-risk
94981,40,154,196,390,high-risk
9499,49,138,193,380,high-risk
94991,12,84,119,215,medium-low-risk
95000,12,149,207,368,high-risk
95001,13,117,131,261,medium-high-risk
95007,0,0,0,0,low-risk
95009,16,124,160,300,medium-high-risk
95011,13,157,198,368,high-risk
95024,0,0,0,0,low-risk
95025,0,0,0,0,low-risk
95032,12,138,122,272,medium-high-risk
95039,13,133,220,366,high-risk
95044,12,144,113,269,medium-high-risk
95048,12,184,220,416,high-risk
95052,0,0,0,0,low-risk
95059,12,125,142,279,medium-high-risk
95061,0,0,0,0,low-risk
95067,12,99,139,250,medium-high-risk
95069,12,83,100,195,medium-low-risk
9508,36,200,241,477,high-risk
95088,0,0,0,0,low-risk
95091,0,0,0,0,low-risk
95092,12,137,149,298,medium-high-risk
95108,12,115,151,278,medium-high-risk
95109,19,103,179,301,medium-high-risk
95132,12,143,168,323,medium-high-risk
95139,12,134,166,312,medium-high-risk
95149,12,92,120,224,medium-low-risk
9515,0,0,0,0,low-risk
95151,0,0,0,0,low-risk
95152,36,133,186,355,high-risk
95160,12,178,197,387,high-risk
95164,0,0,0,0,low-risk
95177,0,0,0,0,low-risk
9518,14,148,186,348,high-risk
95185,11,139,164,314,medium-high-risk
95193,0,0,0,0,low-risk
95204,0,0,0,0,low-risk
95205,0,0,0,0,low-risk
95210,0,0,0,0,low-risk
95213,12,114,136,262,medium-high-risk
95221,0,0,0,0,low-risk
95222,12,84,116,212,medium-low-risk
9523,0,0,0,0,low-risk
95239,0,0,0,0,low-risk
95241,12,84,114,210,medium-low-risk
95243,12,167,211,390,high-risk
95251,0,0,0,0,low-risk
95258,0,0,0,0,low-risk
9526,0,0,0,0,low-risk
95267,12,149,171,332,high-risk
9528,0,0,0,0,low-risk
95281,0,0,0,0,low-risk
95285,0,0,0,0,low-risk
95294,26,132,171,329,medium-high-risk
95299,14,120,222,356,high-risk
95314,12,140,170,322,medium-high-risk
95320,0,0,0,0,low-risk
95327,0,0,0,0,low-risk
9533,0,0,0,0,low-risk
95330,31,108,205,344,high-risk
95337,0,0,0,0,low-risk
95339,22,124,191,337,high-risk
95349,36,128,146,310,medium-high-risk
9535,0,0,0,0,low-risk
95351,35,176,231,442,high-risk
95354,0,0,0,0,low-risk
95365,0,0,0,0,low-risk
95396,0,0,0,0,low-risk
95398,12,132,163,307,medium-high-risk
95405,0,0,0,0,low-risk
95414,26,163,257,446,high-risk
95415,0,0,0,0,low-risk
95418,12,142,178,332,high-risk
95429,27,145,201,373,high-risk
95445,22,173,242,437,high-risk
95452,28,102,169,299,medium-high-risk
95463,28,170,225,423,high-risk
95467,12,121,126,259,medium-high-risk
95470,0,0,0,0,low-risk
95478,28,148,206,382,high-risk
95480,0,0,0,0,low-risk
95488,0,0,0,0,low-risk
95491,0,0,0,0,low-risk
95497,38,129,205,372,high-risk
95503,19,128,169,316,medium-high-risk
95504,21,99,154,274,medium-high-risk
95505,23,125,169,317,medium-high-risk
9551,0,0,0,0,low-risk
95510,0,0,0,0,low-risk
95511,14,163,264,441,high-risk
95518,32,155,231,418,high-risk
95542,0,0,0,0,low-risk
95543,12,134,188,334,high-risk
95556,12,89,167,268,medium-high-risk
95559,53,150,188,391,high-risk
95565,0,0,0,0,low-risk
95578,12,146,108,266,medium-high-risk
95586,0,0,0,0,low-risk
95618,0,0,0,0,low-risk
95627,14,235,169,418,high-risk
95633,12,149,194,355,high-risk
95636,0,0,0,0,low-risk
95638,0,0,0,0,low-risk
9565,0,0,0,0,low-risk
95659,0,0,0,0,low-risk
95681,13,94,185,292,medium-high-risk
95690,12,124,132,268,medium-high-risk
95703,0,0,0,0,low-risk
95707,0,0,0,0,low-risk
95710,12,124,166,302,medium-high-risk
95712,16,90,129,235,medium-low-risk
95714,12,134,196,342,high-risk
95719,29,114,130,273,medium-high-risk
95744,22,157,195,374,high-risk
95749,15,125,185,325,medium-high-risk
95754,12,197,216,425,high-risk
95757,12,101,180,293,medium-high-risk
95763,12,123,149,284,medium-high-risk
95765,12,94,66,172,medium-low-risk
95775,0,0,0,0,low-risk
95776,0,0,0,0,low-risk
95779,0,0,0,0,low-risk
95782,0,0,0,0,low-risk
95783,13,133,183,329,medium-high-risk
95785,12,144,183,339,high-risk
9579,32,167,209,408,high-risk
9580,24,57,228,309,medium-high-risk
95802,12,128,165,305,medium-high-risk
95818,0,0,0,0,low-risk
95828,22,120,163,305,medium-high-risk
95841,0,0,0,0,low-risk
95842,0,0,0,0,low-risk
95843,12,150,177,339,high-risk
95862,19,118,205,342,high-risk
95869,0,0,0,0,low-risk
95870,12,106,130,248,medium-high-risk
95872,0,0,0,0,low-risk
95876,12,98,106,216,medium-low-risk
95880,15,108,153,276,medium-high-risk
95882,19,127,149,295,medium-high-risk
95894,0,0,0,0,low-risk
95906,19,172,158,349,high-risk
95924,12,141,167,320,medium-high-risk
95936,12,175,223,410,high-risk
95944,0,0,0,0,low-risk
95949,18,149,239,406,high-risk
95952,0,0,0,0,low-risk
95953,0,0,0,0,low-risk
95957,12,232,239,483,high-risk
95966,0,0,0,0,low-risk
95970,12,149,164,325,medium-high-risk
95988,12,139,253,404,high-risk
95993,0,0,0,0,low-risk
95994,31,131,168,330,high-risk
9600,23,153,226,402,high-risk
96019,18,89,124,231,medium-low-risk
96023,0,0,0,0,low-risk
96047,0,0,0,0,low-risk
96051,14,142,168,324,medium-high-risk
96055,0,0,0,0,low-risk
96063,0,0,0,0,low-risk
9607,0,0,0,0,low-risk
96078,0,0,0,0,low-risk
96085,22,79,142,243,medium-low-risk
96107,15,159,290,464,high-risk
96121,0,0,0,0,low-risk
96142,12,88,116,216,medium-low-risk
96145,0,0,0,0,low-risk
96162,21,117,179,317,medium-high-risk
96177,14,112,156,282,medium-high-risk
96184,16,159,205,380,high-risk
96186,0,0,0,0,low-risk
96188,12,149,170,331,high-risk
96189,0,0,0,0,low-risk
96193,0,0,0,0,low-risk
96205,0,0,0,0,low-risk
96218,12,165,213,390,high-risk
96219,22,110,163,295,medium-high-risk
96221,0,0,0,0,low-risk
96223,0,0,0,0,low-risk
96236,12,119,141,272,medium-high-risk
96239,12,137,144,293,medium-high-risk
96242,0,0,0,0,low-risk
96254,0,0,0,0,low-risk
96262,25,174,228,427,high-risk
96264,0,0,0,0,low-risk
96265,0,0,0,0,low-risk
96268,32,139,178,349,high-risk
96273,15,110,242,367,high-risk
96280,12,130,177,319,medium-high-risk
96284,23,116,177,316,medium-high-risk
96290,12,194,219,425,high-risk
96321,0,0,0,0,low-risk
96327,0,0,0,0,low-risk
96338,0,0,0,0,low-risk
96340,19,113,167,299,medium-high-risk
96342,12,135,230,377,high-risk
96351,0,0,0,0,low-risk
96360,51,153,250,454,high-risk
96361,0,0,0,0,low-risk
96371,0,0,0,0,low-risk
96382,20,80,119,219,medium-low-risk
96390,14,126,201,341,high-risk
96393,0,0,0,0,low-risk
96395,15,86,130,231,medium-low-risk
96404,12,106,130,248,medium-high-risk
96407,11,89,123,223,medium-low-risk
96412,0,0,0,0,low-risk
96414,0,0,0,0,low-risk
96416,12,131,142,285,medium-high-risk
9642,12,138,175,325,medium-high-risk
96424,0,0,0,0,low-risk
96425,21,116,159,296,medium-high-risk
96430,12,93,147,252,medium-high-risk
96436,22,112,234,368,high-risk
96437,0,0,0,0,low-risk
96447,20,77,113,210,medium-low-risk
96455,0,0,0,0,low-risk
96457,0,0,0,0,low-risk
96468,0,0,0,0,low-risk
9647,0,0,0,0,low-risk
96474,12,164,190,366,high-risk
96475,0,0,0,0,low-risk
96486,0,0,0,0,low-risk
96498,13,145,206,364,high-risk
96499,0,0,0,0,low-risk
96501,0,0,0,0,low-risk
96502,12,97,109,218,medium-low-risk
96505,0,0,0,0,low-risk
96509,12,171,191,374,high-risk
96513,0,0,0,0,low-risk
96514,12,164,183,359,high-risk
96517,12,140,149,301,medium-high-risk
96560,15,244,185,444,high-risk
96564,12,127,137,276,medium-high-risk
96570,11,99,124,234,medium-low-risk
96579,43,181,244,468,high-risk
96582,0,0,0,0,low-risk
96584,0,0,0,0,low-risk
96585,12,81,108,201,medium-low-risk
96592,0,0,0,0,low-risk
96593,12,117,139,268,medium-high-risk
96595,32,133,178,343,high-risk
96596,0,0,0,0,low-risk
9660,12,149,189,350,high-risk
96602,55,152,188,395,high-risk
96606,0,0,0,0,low-risk
96607,0,0,0,0,low-risk
96618,12,125,204,341,high-risk
96620,0,0,0,0,low-risk
96621,0,0,0,0,low-risk
96622,13,128,229,370,high-risk
96627,13,102,148,263,medium-high-risk
96628,0,0,0,0,low-risk
96634,0,0,0,0,low-risk
96641,12,166,187,365,high-risk
96643,14,101,152,267,medium-high-risk
96653,33,166,334,533,high-risk
96660,25,123,201,349,high-risk
96662,0,0,0,0,low-risk
96665,0,0,0,0,low-risk
96668,0,0,0,0,low-risk
96671,12,179,216,407,high-risk
96673,12,139,178,329,medium-high-risk
96675,12,146,172,330,high-risk
96706,12,98,127,237,medium-low-risk
96707,0,0,0,0,low-risk
96710,0,0,0,0,low-risk
96722,13,146,185,344,high-risk
96740,12,136,220,368,high-risk
96759,12,159,226,397,high-risk
9678,12,136,141,289,medium-high-risk
96792,0,0,0,0,low-risk
96802,0,0,0,0,low-risk
96804,12,229,143,384,high-risk
96807,0,0,0,0,low-risk
96808,11,139,155,305,medium-high-risk
96825,17,96,134,247,medium-high-risk
96827,12,85,108,205,medium-low-risk
96838,13,92,128,233,medium-low-risk
96840,0,0,0,0,low-risk
9685,20,149,195,364,high-risk
96852,26,177,247,450,high-risk
96859,0,0,0,0,low-risk
96860,29,96,137,262,medium-high-risk
96861,29,140,176,345,high-risk
9687,41,132,180,353,high-risk
96870,12,142,154,308,medium-high-risk
96873,12,126,214,352,high-risk
96882,12,78,126,216,medium-low-risk
96883,12,136,172,320,medium-high-risk
96886,20,98,135,253,medium-high-risk
96887,0,0,0,0,low-risk
96902,12,104,132,248,medium-high-risk
96905,12,130,148,290,medium-high-risk
9691,23,146,219,388,high-risk
96916,27,192,217,436,high-risk
96918,0,0,0,0,low-risk
96921,37,148,187,372,high-risk
96923,17,144,175,336,high-risk
96940,32,120,200,352,high-risk
96941,13,126,199,338,high-risk
96949,0,0,0,0,low-risk
96950,0,0,0,0,low-risk
96952,12,119,135,266,medium-high-risk
96975,12,180,209,401,high-risk
96993,0,0,0,0,low-risk
97014,0,0,0,0,low-risk
97015,12,140,157,309,medium-high-risk
97030,0,0,0,0,low-risk
97033,12,215,286,513,high-risk
97038,0,0,0,0,low-risk
97063,0,0,0,0,low-risk
97069,42,150,189,381,high-risk
97071,24,105,175,304,medium-high-risk
97091,0,0,0,0,low-risk
97094,12,120,154,286,medium-high-risk
97096,0,0,0,0,low-risk
97097,13,148,222,383,high-risk
97106,12,124,153,289,medium-high-risk
97113,0,0,0,0,low-risk
97116,12,162,212,386,high-risk
97120,0,0,0,0,low-risk
97124,12,117,138,267,medium-high-risk
97131,28,109,156,293,medium-high-risk
97136,0,0,0,0,low-risk
97138,12,77,91,180,medium-low-risk
97139,0,0,0,0,low-risk
97140,12,99,212,323,medium-high-risk
97143,0,0,0,0,low-risk
97149,0,0,0,0,low-risk
97152,17,69,92,178,medium-low-risk
97163,12,118,146,276,medium-high-risk
97171,14,145,255,414,high-risk
97178,0,0,0,0,low-risk
97184,0,0,0,0,low-risk
97198,0,0,0,0,low-risk
97202,0,0,0,0,low-risk
97207,0,0,0,0,low-risk
97224,12,108,170,290,medium-high-risk
97228,0,0,0,0,low-risk
97236,13,90,134,237,medium-low-risk
97239,0,0,0,0,low-risk
9724,19,231,194,444,high-risk
97241,17,137,177,331,high-risk
97250,12,142,175,329,medium-high-risk
97259,0,0,0,0,low-risk
97260,0,0,0,0,low-risk
97263,0,0,0,0,low-risk
97272,12,109,129,250,medium-high-risk
97275,18,111,157,286,medium-high-risk
97288,12,105,124,241,medium-low-risk
97301,46,136,208,390,high-risk
97306,12,125,187,324,medium-high-risk
97312,0,0,0,0,low-risk
97320,0,0,0,0,low-risk
97329,0,0,0,0,low-risk
97331,0,0,0,0,low-risk
97337,14,97,126,237,medium-low-risk
97342,0,0,0,0,low-risk
97343,0,0,0,0,low-risk
97344,0,0,0,0,low-risk
97348,12,103,128,243,medium-low-risk
97353,0,0,0,0,low-risk
9736,0,0,0,0,low-risk
97369,12,104,223,339,high-risk
97372,12,115,170,297,medium-high-risk
97374,12,139,211,362,high-risk
97381,12,127,202,341,high-risk
97383,0,0,0,0,low-risk
97385,0,0,0,0,low-risk
9739,0,0,0,0,low-risk
9740,12,123,155,290,medium-high-risk
97403,0,0,0,0,low-risk
97407,0,0,0,0,low-risk
97416,0,0,0,0,low-risk
97419,12,164,192,368,high-risk
97440,0,0,0,0,low-risk
97445,0,0,0,0,low-risk
97446,12,130,155,297,medium-high-risk
97454,12,193,239,444,high-risk
97460,22,176,229,427,high-risk
97465,0,0,0,0,low-risk
97468,0,0,0,0,low-risk
97469,13,81,121,215,medium-low-risk
97471,13,94,132,239,medium-low-risk
97477,0,0,0,0,low-risk
97479,0,0,0,0,low-risk
97503,12,132,168,312,medium-high-risk
97507,12,192,210,414,high-risk
97515,0,0,0,0,low-risk
97517,33,133,184,350,high-risk
97522,0,0,0,0,low-risk
97523,17,116,151,284,medium-high-risk
97530,17,147,255,419,high-risk
97540,0,0,0,0,low-risk
97554,13,129,264,406,high-risk
9756,12,104,120,236,medium-low-risk
97568,0,0,0,0,low-risk
97573,13,133,178,324,medium-high-risk
97577,0,0,0,0,low-risk
97579,0,0,0,0,low-risk
97581,12,116,136,264,medium-high-risk
97587,12,97,132,241,medium-low-risk
97588,0,0,0,0,low-risk
97595,12,170,223,405,high-risk
97602,13,109,140,262,medium-high-risk
97611,0,0,0,0,low-risk
97632,14,108,160,282,medium-high-risk
97633,15,88,141,244,medium-low-risk
97640,12,112,124,248,medium-high-risk
97649,28,158,264,450,high-risk
97657,13,153,197,363,high-risk
97659,12,101,150,263,medium-high-risk
97670,16,112,180,308,medium-high-risk
97671,12,139,152,303,medium-high-risk
97699,0,0,0,0,low-risk
9771,0,0,0,0,low-risk
97710,0,0,0,0,low-risk
97714,14,122,262,398,high-risk
97727,0,0,0,0,low-risk
97728,13,124,172,309,medium-high-risk
97731,12,92,137,241,medium-low-risk
97735,12,86,142,240,medium-low-risk
97747,23,176,224,423,high-risk
97754,20,151,192,363,high-risk
97768,20,121,158,299,medium-high-risk
97770,0,0,0,0,low-risk
97772,22,105,165,292,medium-high-risk
97786,31,142,153,326,medium-high-risk
97790,12,134,153,299,medium-high-risk
97791,12,117,233,362,high-risk
97796,0,0,0,0,low-risk
97803,12,77,119,208,medium-low-risk
97806,12,113,165,290,medium-high-risk
97810,16,163,265,444,high-risk
97829,12,152,173,337,high-risk
97831,17,123,143,283,medium-high-risk
97832,18,131,169,318,medium-high-risk
97833,27,107,166,300,medium-high-risk
97836,0,0,0,0,low-risk
97854,38,143,210,391,high-risk
97861,12,134,139,285,medium-high-risk
97864,0,0,0,0,low-risk
97867,14,96,134,244,medium-low-risk
97870,0,0,0,0,low-risk
97872,0,0,0,0,low-risk
97873,28,103,261,392,high-risk
97886,13,115,134,262,medium-high-risk
97894,0,0,0,0,low-risk
97895,0,0,0,0,low-risk
97898,16,139,172,327,medium-high-risk
97904,0,0,0,0,low-risk
97914,12,265,138,415,high-risk
97917,0,0,0,0,low-risk
97921,14,116,199,329,medium-high-risk
97922,12,108,139,259,medium-high-risk
97923,19,102,146,267,medium-high-risk
97928,13,123,167,303,medium-high-risk
97935,0,0,0,0,low-risk
97940,48,122,321,491,high-risk
97950,0,0,0,0,low-risk
97955,12,110,130,252,medium-high-risk
97960,12,150,174,336,high-risk
97961,12,109,141,262,medium-high-risk
97962,0,0,0,0,low-risk
97972,0,0,0,0,low-risk
97979,12,156,220,388,high-risk
97981,0,0,0,0,low-risk
97986,0,0,0,0,low-risk
97997,11,61,81,153,medium-low-risk
98028,0,0,0,0,low-risk
98031,12,123,157,292,medium-high-risk
9804,0,0,0,0,low-risk
98053,0,0,0,0,low-risk
98060,0,0,0,0,low-risk
98061,0,0,0,0,low-risk
98062,12,158,137,307,medium-high-risk
98064,26,180,222,428,high-risk
98065,19,91,151,261,medium-high-risk
98066,12,89,162,263,medium-high-risk
98072,13,70,123,206,medium-low-risk
98075,0,0,0,0,low-risk
98083,36,121,183,340,high-risk
98099,22,130,182,334,high-risk
98102,31,133,179,343,high-risk
98113,0,0,0,0,low-risk
98119,18,175,239,432,high-risk
98135,12,156,215,383,high-risk
98159,28,136,206,370,high-risk
98168,0,0,0,0,low-risk
98171,12,163,217,392,high-risk
98179,0,0,0,0,low-risk
98184,11,112,152,275,medium-high-risk
98187,14,236,171,421,high-risk
98199,0,0,0,0,low-risk
9820,12,134,154,300,medium-high-risk
98203,12,175,205,392,high-risk
98219,14,139,150,303,medium-high-risk
98220,12,112,128,252,medium-high-risk
98225,20,222,172,414,high-risk
98229,0,0,0,0,low-risk
9823,0,0,0,0,low-risk
98230,12,162,204,378,high-risk
98238,20,217,142,379,high-risk
98245,12,76,146,234,medium-low-risk
98249,12,117,166,295,medium-high-risk
98252,0,0,0,0,low-risk
98263,0,0,0,0,low-risk
98266,0,0,0,0,low-risk
98269,0,0,0,0,low-risk
98271,18,112,135,265,medium-high-risk
9828,0,0,0,0,low-risk
98285,0,0,0,0,low-risk
98293,0,0,0,0,low-risk
98303,12,164,242,418,high-risk
98305,12,164,224,400,high-risk
98316,13,79,129,221,medium-low-risk
98332,14,130,229,373,high-risk
98333,0,0,0,0,low-risk
98336,29,91,156,276,medium-high-risk
98346,12,137,135,284,medium-high-risk
98354,13,84,110,207,medium-low-risk
98357,0,0,0,0,low-risk
98363,31,162,210,403,high-risk
98373,12,79,119,210,medium-low-risk
98405,12,121,130,263,medium-high-risk
98410,12,106,145,263,medium-high-risk
98422,0,0,0,0,low-risk
98434,12,102,128,242,medium-low-risk
98439,0,0,0,0,low-risk
98440,0,0,0,0,low-risk
98443,12,122,106,240,medium-low-risk
98446,0,0,0,0,low-risk
98452,12,117,136,265,medium-high-risk
98456,0,0,0,0,low-risk
98458,13,114,208,335,high-risk
98468,12,154,167,333,high-risk
98473,12,157,187,356,high-risk
98475,12,106,131,249,medium-high-risk
98476,36,166,226,428,high-risk
98481,0,0,0,0,low-risk
98491,12,155,312,479,high-risk
98502,18,145,249,412,high-risk
98519,12,39,63,114,medium-low-risk
98522,20,84,142,246,medium-high-risk
98532,0,0,0,0,low-risk
98534,0,0,0,0,low-risk
9854,0,0,0,0,low-risk
98542,12,128,146,286,medium-high-risk
98543,38,114,150,302,medium-high-risk
9855,0,0,0,0,low-risk
98550,0,0,0,0,low-risk
98552,33,203,267,503,high-risk
98556,12,145,194,351,high-risk
98560,12,266,132,410,high-risk
98565,0,0,0,0,low-risk
98569,12,157,213,382,high-risk
98574,12,117,191,320,medium-high-risk
98576,0,0,0,0,low-risk
98578,19,114,154,287,medium-high-risk
98582,0,0,0,0,low-risk
98590,12,151,158,321,medium-high-risk
98597,0,0,0,0,low-risk
98606,22,104,153,279,medium-high-risk
98611,12,121,150,283,medium-high-risk
98626,17,165,198,380,high-risk
98634,29,92,147,268,medium-high-risk
98646,41,145,185,371,high-risk
98650,20,122,178,320,medium-high-risk
98658,0,0,0,0,low-risk
98668,12,130,159,301,medium-high-risk
98674,12,97,141,250,medium-high-risk
98679,12,122,140,274,medium-high-risk
98685,0,0,0,0,low-risk
9869,12,166,240,418,high-risk
98693,13,117,174,304,medium-high-risk
98701,22,128,216,366,high-risk
98703,0,0,0,0,low-risk
98706,0,0,0,0,low-risk
98708,12,109,132,253,medium-high-risk
9871,0,0,0,0,low-risk
98722,50,159,186,395,high-risk
98725,0,0,0,0,low-risk
9874,31,142,277,450,high-risk
98751,41,129,151,321,medium-high-risk
9876,0,0,0,0,low-risk
98761,12,157,267,436,high-risk
98762,16,102,159,277,medium-high-risk
98783,46,190,231,467,high-risk
98785,0,0,0,0,low-risk
9879,0,0,0,0,low-risk
9880,28,108,184,320,medium-high-risk
98802,0,0,0,0,low-risk
98805,0,0,0,0,low-risk
98837,12,116,158,286,medium-high-risk
98840,21,96,191,308,medium-high-risk
98842,21,124,156,301,medium-high-risk
98845,0,0,0,0,low-risk
98847,12,149,202,363,high-risk
9885,0,0,0,0,low-risk
98861,12,89,108,209,medium-low-risk
98866,0,0,0,0,low-risk
98875,0,0,0,0,low-risk
98880,0,0,0,0,low-risk
98884,0,0,0,0,low-risk
98887,0,0,0,0,low-risk
98888,0,0,0,0,low-risk
98889,11,122,113,246,medium-high-risk
98898,12,153,192,357,high-risk
98923,12,142,179,333,high-risk
98924,41,144,210,395,high-risk
98938,0,0,0,0,low-risk
9894,12,145,203,360,high-risk
98951,0,0,0,0,low-risk
98971,0,0,0,0,low-risk
98972,0,0,0,0,low-risk
98985,12,137,200,349,high-risk
98987,30,126,172,328,medium-high-risk
98993,12,160,176,348,high-risk
98994,28,95,127,250,medium-high-risk
9900,29,177,243,449,high-risk
99007,40,145,219,404,high-risk
99008,0,0,0,0,low-risk
99012,43,155,358,556,high-risk
99019,0,0,0,0,low-risk
99023,12,161,181,354,high-risk
99024,0,0,0,0,low-risk
99025,13,81,127,221,medium-low-risk
99035,0,0,0,0,low-risk
99037,0,0,0,0,low-risk
99041,0,0,0,0,low-risk
99051,12,118,132,262,medium-high-risk
99057,58,210,342,610,high-risk
99059,12,157,224,393,high-risk
99062,0,0,0,0,low-risk
99064,12,131,149,292,medium-high-risk
99066,0,0,0,0,low-risk
99082,0,0,0,0,low-risk
9909,0,0,0,0,low-risk
99090,0,0,0,0,low-risk
99092,28,216,272,516,high-risk
99095,27,117,162,306,medium-high-risk
99102,12,122,154,288,medium-high-risk
99104,0,0,0,0,low-risk
99112,0,0,0,0,low-risk
99127,15,113,155,283,medium-high-risk
99143,0,0,0,0,low-risk
99147,0,0,0,0,low-risk
99152,12,113,142,267,medium-high-risk
99157,0,0,0,0,low-risk
9916,25,257,213,495,high-risk
99162,0,0,0,0,low-risk
99172,0,0,0,0,low-risk
99174,0,0,0,0,low-risk
99175,0,0,0,0,low-risk
99182,32,138,155,325,medium-high-risk
99186,0,0,0,0,low-risk
99211,12,158,199,369,high-risk
99214,12,106,148,266,medium-high-risk
99215,24,110,140,274,medium-high-risk
99232,0,0,0,0,low-risk
99238,22,177,232,431,high-risk
9925,47,142,229,418,high-risk
99275,12,154,190,356,high-risk
9928,30,112,146,288,medium-high-risk
99283,12,151,180,343,high-risk
99288,44,168,280,492,high-risk
99289,0,0,0,0,low-risk
99291,0,0,0,0,low-risk
99305,0,0,0,0,low-risk
99323,0,0,0,0,low-risk
99324,0,0,0,0,low-risk
99325,12,113,165,290,medium-high-risk
99326,23,128,186,337,high-risk
99332,0,0,0,0,low-risk
99335,25,106,159,290,medium-high-risk
99338,0,0,0,0,low-risk
99339,20,155,213,388,high-risk
99346,0,0,0,0,low-risk
99351,28,147,305,480,high-risk
9936,19,82,141,242,medium-low-risk
99363,21,204,280,505,high-risk
99365,26,147,202,375,high-risk
99368,13,131,227,371,high-risk
99376,12,168,118,298,medium-high-risk
99381,0,0,0,0,low-risk
9939,0,0,0,0,low-risk
99398,0,0,0,0,low-risk
99403,12,111,149,272,medium-high-risk
99405,0,0,0,0,low-risk
99408,29,143,188,360,high-risk
99410,13,97,126,236,medium-low-risk
99422,0,0,0,0,low-risk
99434,12,126,138,276,medium-high-risk
9944,12,114,153,279,medium-high-risk
99445,0,0,0,0,low-risk
99447,16,146,195,357,high-risk
99452,0,0,0,0,low-risk
99456,0,0,0,0,low-risk
99459,0,0,0,0,low-risk
99466,0,0,0,0,low-risk
99481,12,166,115,293,medium-high-risk
99483,12,108,142,262,medium-high-risk
99485,0,0,0,0,low-risk
99492,25,85,249,359,high-risk
99496,0,0,0,0,low-risk
99497,0,0,0,0,low-risk
99504,0,0,0,0,low-risk
99506,0,0,0,0,low-risk
9951,12,86,113,211,medium-low-risk
99510,0,0,0,0,low-risk
99515,36,142,184,362,high-risk
99517,0,0,0,0,low-risk
99533,0,0,0,0,low-risk
99536,24,140,175,339,high-risk
99539,11,129,165,305,medium-high-risk
99565,0,0,0,0,low-risk
99569,13,101,148,262,medium-high-risk
99573,0,0,0,0,low-risk
99578,13,102,169,284,medium-high-risk
99580,12,126,224,362,high-risk
99581,12,129,134,275,medium-high-risk
99589,0,0,0,0,low-risk
99590,0,0,0,0,low-risk
99594,0,0,0,0,low-risk
99600,0,0,0,0,low-risk
99609,34,102,144,280,medium-high-risk
9962,0,0,0,0,low-risk
99622,0,0,0,0,low-risk
99623,36,130,174,340,high-risk
99624,0,0,0,0,low-risk
99625,0,0,0,0,low-risk
99629,0,0,0,0,low-risk
99639,0,0,0,0,low-risk
99643,0,0,0,0,low-risk
99651,0,0,0,0,low-risk
99657,15,79,126,220,medium-low-risk
99658,12,113,137,262,medium-high-risk
9966,0,0,0,0,low-risk
99663,12,135,149,296,medium-high-risk
99666,12,136,169,317,medium-high-risk
9967,0,0,0,0,low-risk
99689,12,121,131,264,medium-high-risk
99691,12,147,238,397,high-risk
99693,12,108,131,251,medium-high-risk
99708,34,136,197,367,high-risk
99715,0,0,0,0,low-risk
99723,0,0,0,0,low-risk
99726,12,154,184,350,high-risk
99733,0,0,0,0,low-risk
99735,18,92,174,284,medium-high-risk
99744,0,0,0,0,low-risk
99754,0,0,0,0,low-risk
99769,18,84,131,233,medium-low-risk
99772,12,98,131,241,medium-low-risk
99786,0,0,0,0,low-risk
99789,0,0,0,0,low-risk
99790,26,127,168,321,medium-high-risk
99794,12,68,112,192,medium-low-risk
99799,12,105,141,258,medium-high-risk
99804,0,0,0,0,low-risk
99807,12,139,157,308,medium-high-risk
99812,12,97,220,329,medium-high-risk
99814,13,174,267,454,high-risk
99815,20,82,130,232,medium-low-risk
99826,12,124,153,289,medium-high-risk
9983,26,151,182,359,high-risk
99833,13,121,158,292,medium-high-risk
99834,0,0,0,0,low-risk
99836,12,118,148,278,medium-high-risk
99840,12,139,172,323,medium-high-risk
9985,0,0,0,0,low-risk
99850,0,0,0,0,low-risk
99851,12,190,212,414,high-risk
99856,0,0,0,0,low-risk
99868,12,92,118,222,medium-low-risk
99869,0,0,0,0,low-risk
99884,25,126,268,419,high-risk
99887,12,186,214,412,high-risk
99891,12,98,128,238,medium-low-risk
99894,0,0,0,0,low-risk
99895,12,97,145,254,medium-high-risk
99904,0,0,0,0,low-risk
99918,0,0,0,0,low-risk
99939,14,147,232,393,high-risk
99943,0,0,0,0,low-risk
99947,0,0,0,0,low-risk
99949,16,91,128,235,medium-low-risk
99952,12,147,178,337,high-risk
99963,0,0,0,0,low-risk
99965,0,0,0,0,low-risk
99988,12,128,181,321,medium-high-risk
99998,28,172,224,424,high-risk
